//MAP CONVERTED BY dmm2tgm.py THIS HEADER COMMENT PREVENTS RECONVERSION, DO NOT REMOVE
"aF" = (
/obj/structure/closet/firecloset,
/obj/structure/aurora/wall_light{
	dir = 4
	},
/turf/simulated/floor/holofloor/tiled,
/area/map_template/bunker)
"br" = (
/obj/structure/table/steel_reinforced,
/obj/structure/aurora/wall_light{
	dir = 1
	},
/obj/random/contraband,
/turf/simulated/floor/holofloor/tiled,
/area/map_template/bunker)
"bI" = (
/obj/machinery/r_n_d/circuit_imprinter,
/obj/structure/aurora/wall_light{
	dir = 1
	},
/turf/simulated/floor/holofloor/tiled,
/area/map_template/bunker)
"bX" = (
/obj/machinery/computer/rdconsole/core/colony{
	req_access = list();
	dir = 1
	},
/turf/simulated/floor/holofloor/tiled,
/area/map_template/bunker)
"cb" = (
/obj/structure/hygiene/toilet{
	dir = 8
	},
/turf/simulated/floor/holofloor/tiled,
/area/map_template/bunker)
"cg" = (
/turf/simulated/wall/titanium,
/area/map_template/bunker)
"dj" = (
/obj/structure/rubble/house,
/obj/random/trash,
/obj/item/stack/material/rods,
/obj/floor_decal/snow,
/turf/simulated/floor/holofloor/tiled,
/area/template_noop)
"eb" = (
/obj/structure/hygiene/sink{
	pixel_y = -12
	},
/turf/simulated/floor/holofloor/tiled,
/area/map_template/bunker)
"eL" = (
/obj/structure/closet/emcloset,
/turf/simulated/floor/holofloor/tiled,
/area/map_template/bunker)
"fn" = (
/obj/machinery/vending/tool,
/obj/floor_decal/snow,
/turf/simulated/floor/holofloor/tiled,
/area/map_template/bunker)
"fr" = (
/obj/random/trash,
/turf/simulated/floor/exoplanet/snow,
/area/template_noop)
"fH" = (
/turf/simulated/wall/titanium,
/area/template_noop)
"gP" = (
/obj/structure/aurora/wall_light{
	dir = 1
	},
/obj/decal/cleanable/generic,
/turf/simulated/floor/holofloor/tiled,
/area/map_template/bunker)
"hn" = (
/obj/structure/aurora/wall_light{
	dir = 1
	},
/turf/simulated/floor/exoplanet/snow,
/area/template_noop)
"hq" = (
/obj/decal/cleanable/generic,
/turf/simulated/floor/exoplanet/snow,
/area/template_noop)
"ib" = (
/obj/machinery/washing_machine,
/turf/simulated/floor/holofloor/tiled,
/area/map_template/bunker)
"kt" = (
/obj/anomaly/electra/three_and_three/tesla_second,
/turf/simulated/floor/exoplanet/snow,
/area/template_noop)
"kM" = (
/obj/structure/closet/radiation,
/turf/simulated/floor/holofloor/tiled,
/area/map_template/bunker)
"lJ" = (
/obj/structure/bed/chair/comfy/brown,
/obj/decal/cleanable/generic,
/turf/simulated/floor/holofloor/tiled,
/area/map_template/bunker)
"lN" = (
/obj/machinery/constructable_frame,
/obj/floor_decal/snow,
/turf/simulated/floor/holofloor/tiled,
/area/template_noop)
"lO" = (
/obj/structure/rubble/house,
/obj/random/trash,
/obj/structure/largecrate,
/obj/random/loot,
/obj/random/loot,
/obj/random/loot,
/obj/random/loot,
/obj/random/loot,
/obj/floor_decal/snow,
/turf/simulated/floor/holofloor/tiled,
/area/template_noop)
"lS" = (
/obj/machinery/portable_atmospherics/canister/oxygen,
/obj/structure/railing/mapped{
	dir = 1;
	icon_state = "railing0-1"
	},
/turf/simulated/floor/holofloor/tiled,
/area/map_template/bunker)
"mb" = (
/obj/random/trash,
/obj/floor_decal/snow,
/turf/simulated/floor/holofloor/tiled,
/area/template_noop)
"op" = (
/obj/structure/aurora/wall_light{
	dir = 8
	},
/obj/machinery/vending/engineering{
	req_access = list()
	},
/obj/floor_decal/snow,
/turf/simulated/floor/holofloor/tiled,
/area/map_template/bunker)
"oS" = (
/obj/structure/aurora/wall_light,
/turf/simulated/floor/holofloor/tiled,
/area/map_template/bunker)
"pl" = (
/obj/structure/reagent_dispensers/watertank,
/turf/simulated/floor/holofloor/tiled,
/area/map_template/bunker)
"qc" = (
/obj/structure/rubble/house,
/obj/item/stack/material/rods,
/turf/simulated/floor/holofloor/tiled,
/area/template_noop)
"qL" = (
/obj/structure/table/steel_reinforced,
/obj/random/contraband,
/turf/simulated/floor/holofloor/tiled,
/area/map_template/bunker)
"qM" = (
/obj/machinery/anomaly_container{
	req_access = list()
	},
/turf/simulated/floor/holofloor/tiled,
/area/map_template/bunker)
"ro" = (
/obj/structure/rubble/house,
/turf/simulated/floor/holofloor/tiled,
/area/map_template/bunker)
"tT" = (
/obj/machinery/r_n_d/destructive_analyzer,
/obj/structure/extinguisher_cabinet{
	pixel_x = -7;
	pixel_y = 32
	},
/turf/simulated/floor/holofloor/tiled,
/area/map_template/bunker)
"ua" = (
/obj/structure/grille/broken,
/obj/anomaly/electra/three_and_three/tesla_second,
/turf/simulated/floor/exoplanet/snow,
/area/template_noop)
"uE" = (
/obj/structure/aurora/beaker_dropper,
/obj/structure/aurora/wall_light{
	dir = 1
	},
/turf/simulated/floor/holofloor/tiled,
/area/map_template/bunker)
"uX" = (
/obj/structure/rubble/house,
/obj/random/trash,
/turf/simulated/floor/holofloor/tiled,
/area/template_noop)
"vg" = (
/obj/structure/rubble/house,
/obj/structure/aurora/wall_light{
	dir = 1
	},
/turf/simulated/floor/holofloor/tiled,
/area/map_template/bunker)
"vR" = (
/obj/structure/broken_door,
/obj/floor_decal/snow,
/turf/simulated/floor/holofloor/tiled,
/area/map_template/bunker)
"vW" = (
/obj/structure/bed/padded{
	dir = 1
	},
/obj/item/bedsheet/hop,
/obj/structure/curtain/open/bed,
/turf/simulated/floor/holofloor/tiled,
/area/map_template/bunker)
"wa" = (
/obj/structure/largecrate,
/obj/random/loot,
/obj/random/loot,
/obj/random/loot,
/obj/random/loot,
/obj/random/loot,
/obj/floor_decal/snow,
/turf/simulated/floor/holofloor/tiled,
/area/template_noop)
"wv" = (
/obj/structure/table/steel_reinforced,
/obj/machinery/door/window{
	autoset_access = 0;
	dir = 1;
	pixel_y = -26
	},
/obj/machinery/door/window{
	autoset_access = 0;
	dir = 1
	},
/turf/simulated/floor/holofloor/tiled,
/area/map_template/bunker)
"wM" = (
/obj/structure/rubble/house,
/obj/random/trash,
/obj/floor_decal/snow,
/turf/simulated/floor/holofloor/tiled,
/area/template_noop)
"wQ" = (
/turf/template_noop,
/area/template_noop)
"xu" = (
/obj/structure/girder/displaced,
/turf/simulated/floor/exoplanet/snow,
/area/template_noop)
"xG" = (
/obj/machinery/vending/engivend{
	req_access = list()
	},
/turf/simulated/floor/holofloor/tiled,
/area/map_template/bunker)
"xJ" = (
/obj/structure/rubble/house,
/turf/simulated/floor/holofloor/tiled,
/area/template_noop)
"zk" = (
/obj/wallframe_spawn/reinforced/titanium,
/turf/template_noop,
/area/map_template/bunker)
"zW" = (
/obj/structure/curtain/open/shower,
/turf/simulated/floor/holofloor/tiled,
/area/map_template/bunker)
"AB" = (
/turf/simulated/floor/holofloor/tiled,
/area/map_template/bunker)
"By" = (
/obj/item/stack/material/rods,
/turf/simulated/floor/exoplanet/snow,
/area/template_noop)
"BS" = (
/obj/structure/aurora/smes,
/turf/simulated/floor/holofloor/tiled,
/area/map_template/bunker)
"CI" = (
/obj/structure/aurora/wall_light{
	dir = 1
	},
/obj/floor_decal/snow,
/turf/simulated/floor/tiled/techmaint,
/area/map_template/bunker)
"Dr" = (
/obj/structure/rubble/house,
/obj/decal/cleanable/generic,
/obj/floor_decal/snow,
/turf/simulated/floor/holofloor/tiled,
/area/template_noop)
"Ek" = (
/obj/machinery/door/blast/regular,
/obj/structure/broken_door,
/turf/simulated/floor/holofloor/tiled,
/area/map_template/bunker)
"Fi" = (
/obj/structure/largecrate,
/obj/random/loot,
/obj/random/loot,
/obj/random/loot,
/obj/random/loot,
/obj/random/loot,
/turf/simulated/floor/exoplanet/snow,
/area/template_noop)
"FP" = (
/obj/structure/table/rack,
/obj/item/clothing/suit/space/void/atmos,
/obj/item/clothing/head/helmet/space/void/atmos,
/obj/item/tank/oxygen,
/obj/structure/railing/mapped{
	dir = 1;
	icon_state = "railing0-1"
	},
/turf/simulated/floor/holofloor/tiled,
/area/map_template/bunker)
"Gy" = (
/obj/structure/rubble/house,
/obj/random/trash,
/obj/item/stack/material/rods,
/turf/simulated/floor/holofloor/tiled,
/area/template_noop)
"GD" = (
/obj/structure/bed/padded{
	dir = 1
	},
/obj/item/bedsheet/hop,
/obj/structure/curtain/open/bed,
/turf/simulated/floor/holofloor/tiled,
/area/template_noop)
"GF" = (
/obj/structure/aurora/wall_light{
	dir = 8
	},
/turf/simulated/floor/holofloor/tiled,
/area/map_template/bunker)
"Hk" = (
/obj/structure/rubble/house,
/obj/decal/cleanable/generic,
/turf/simulated/floor/holofloor/tiled,
/area/template_noop)
"HI" = (
/obj/structure/hygiene/shower{
	dir = 4
	},
/turf/simulated/floor/holofloor/tiled,
/area/map_template/bunker)
"Ih" = (
/obj/structure/dispenser/oxygen,
/turf/simulated/floor/holofloor/tiled,
/area/map_template/bunker)
"IH" = (
/obj/random/masks,
/turf/simulated/floor/exoplanet/snow,
/area/template_noop)
"IS" = (
/obj/machinery/door/airlock,
/turf/simulated/floor/holofloor/tiled,
/area/map_template/bunker)
"KT" = (
/obj/structure/table/steel_reinforced,
/obj/random/toolbox,
/turf/simulated/floor/holofloor/tiled,
/area/map_template/bunker)
"Lx" = (
/obj/decal/cleanable/generic,
/turf/simulated/floor/holofloor/tiled,
/area/map_template/bunker)
"OQ" = (
/obj/structure/table/steel_reinforced,
/turf/simulated/floor/holofloor/tiled,
/area/map_template/bunker)
"Pi" = (
/obj/machinery/door/blast/regular/open,
/obj/structure/broken_door,
/turf/simulated/floor/exoplanet/snow,
/area/template_noop)
"Pk" = (
/obj/structure/aurora/old_comp,
/obj/structure/table/steel_reinforced,
/turf/simulated/floor/holofloor/tiled,
/area/map_template/bunker)
"Pl" = (
/obj/structure/aurora/wall_light{
	dir = 1
	},
/turf/simulated/floor/holofloor/tiled,
/area/map_template/bunker)
"Tb" = (
/obj/machinery/r_n_d/protolathe,
/turf/simulated/floor/holofloor/tiled,
/area/map_template/bunker)
"Td" = (
/obj/structure/aurora/wall_light,
/turf/simulated/floor/exoplanet/snow,
/area/template_noop)
"TO" = (
/obj/machinery/door/blast/regular/open,
/obj/structure/broken_door,
/obj/floor_decal/snow,
/turf/simulated/floor/tiled/techmaint,
/area/map_template/bunker)
"Vd" = (
/obj/structure/rubble/house,
/obj/floor_decal/snow,
/turf/simulated/floor/holofloor/tiled,
/area/template_noop)
"Vi" = (
/obj/structure/table/steel_reinforced,
/obj/structure/aurora/wall_light{
	dir = 4
	},
/turf/simulated/floor/holofloor/tiled,
/area/map_template/bunker)
"WC" = (
/obj/machinery/stasis_cage{
	req_access = list()
	},
/obj/floor_decal/snow,
/turf/simulated/floor/holofloor/tiled,
/area/template_noop)
"XD" = (
/obj/structure/grille/broken,
/turf/simulated/floor/exoplanet/snow,
/area/template_noop)
"Yr" = (
/obj/structure/table/steel_reinforced,
/obj/item/device/integrated_circuit_printer/upgraded{
	pixel_y = 2
	},
/obj/item/storage/toolbox/mechanical{
	pixel_y = -12
	},
/obj/item/clothing/glasses/science,
/turf/simulated/floor/holofloor/tiled,
/area/map_template/bunker)
"Yv" = (
/obj/floor_decal/snow,
/turf/simulated/floor/holofloor/tiled,
/area/map_template/bunker)
"YK" = (
/obj/structure/grille/broken,
/obj/item/stack/material/rods,
/turf/simulated/floor/exoplanet/snow,
/area/template_noop)
"Zu" = (
/obj/wallframe_spawn/reinforced/titanium,
/turf/simulated/wall/titanium,
/area/map_template/bunker)
"ZL" = (
/turf/simulated/floor/exoplanet/snow,
/area/template_noop)

(1,1,1) = {"
wQ
wQ
wQ
wQ
wQ
wQ
wQ
wQ
wQ
wQ
wQ
wQ
wQ
wQ
wQ
wQ
wQ
wQ
wQ
wQ
wQ
wQ
wQ
wQ
wQ
wQ
wQ
wQ
wQ
wQ
wQ
wQ
wQ
wQ
wQ
wQ
wQ
wQ
wQ
wQ
wQ
"}
(2,1,1) = {"
wQ
wQ
wQ
wQ
wQ
wQ
wQ
wQ
wQ
wQ
wQ
wQ
wQ
wQ
wQ
wQ
wQ
wQ
wQ
wQ
wQ
wQ
wQ
wQ
wQ
wQ
wQ
wQ
wQ
wQ
wQ
wQ
wQ
wQ
wQ
wQ
wQ
wQ
wQ
wQ
wQ
"}
(3,1,1) = {"
wQ
wQ
wQ
wQ
wQ
wQ
wQ
wQ
wQ
wQ
wQ
wQ
wQ
wQ
wQ
wQ
wQ
wQ
wQ
wQ
wQ
wQ
wQ
wQ
wQ
wQ
wQ
wQ
wQ
wQ
wQ
wQ
wQ
wQ
wQ
wQ
wQ
wQ
wQ
wQ
wQ
"}
(4,1,1) = {"
wQ
wQ
wQ
wQ
wQ
wQ
wQ
wQ
wQ
wQ
wQ
wQ
wQ
wQ
wQ
wQ
wQ
wQ
wQ
wQ
wQ
wQ
wQ
wQ
wQ
wQ
wQ
wQ
wQ
wQ
wQ
wQ
wQ
wQ
wQ
wQ
wQ
wQ
wQ
wQ
wQ
"}
(5,1,1) = {"
wQ
wQ
wQ
wQ
wQ
wQ
wQ
wQ
wQ
wQ
wQ
wQ
wQ
wQ
wQ
wQ
wQ
wQ
wQ
wQ
wQ
wQ
wQ
wQ
wQ
wQ
wQ
wQ
wQ
wQ
wQ
wQ
wQ
wQ
wQ
wQ
wQ
wQ
wQ
wQ
wQ
"}
(6,1,1) = {"
wQ
wQ
wQ
wQ
wQ
wQ
wQ
wQ
wQ
wQ
wQ
wQ
wQ
wQ
wQ
wQ
wQ
wQ
wQ
wQ
wQ
wQ
wQ
wQ
wQ
wQ
wQ
wQ
wQ
wQ
wQ
wQ
wQ
wQ
wQ
wQ
wQ
wQ
wQ
wQ
wQ
"}
(7,1,1) = {"
wQ
wQ
wQ
wQ
wQ
wQ
wQ
wQ
wQ
wQ
wQ
wQ
wQ
wQ
wQ
wQ
wQ
wQ
wQ
wQ
wQ
wQ
wQ
wQ
wQ
wQ
wQ
wQ
wQ
wQ
wQ
wQ
wQ
wQ
wQ
wQ
wQ
wQ
wQ
wQ
wQ
"}
(8,1,1) = {"
wQ
wQ
wQ
wQ
wQ
wQ
wQ
wQ
wQ
wQ
wQ
wQ
wQ
wQ
wQ
wQ
wQ
wQ
wQ
wQ
wQ
wQ
wQ
wQ
wQ
wQ
wQ
wQ
wQ
wQ
wQ
wQ
wQ
wQ
wQ
wQ
wQ
wQ
wQ
wQ
wQ
"}
(9,1,1) = {"
wQ
wQ
wQ
wQ
wQ
wQ
wQ
wQ
wQ
wQ
wQ
wQ
wQ
wQ
wQ
wQ
wQ
wQ
wQ
wQ
wQ
wQ
wQ
wQ
wQ
wQ
wQ
wQ
wQ
wQ
wQ
wQ
wQ
wQ
wQ
wQ
wQ
wQ
wQ
wQ
wQ
"}
(10,1,1) = {"
wQ
wQ
wQ
wQ
wQ
wQ
wQ
wQ
wQ
wQ
wQ
wQ
wQ
wQ
wQ
wQ
wQ
wQ
wQ
wQ
wQ
wQ
wQ
wQ
wQ
wQ
wQ
wQ
wQ
wQ
wQ
wQ
wQ
wQ
wQ
wQ
wQ
wQ
wQ
wQ
wQ
"}
(11,1,1) = {"
wQ
wQ
wQ
wQ
wQ
wQ
wQ
wQ
wQ
wQ
wQ
wQ
wQ
wQ
wQ
wQ
wQ
wQ
wQ
wQ
wQ
wQ
wQ
wQ
wQ
wQ
wQ
wQ
wQ
wQ
wQ
wQ
wQ
wQ
wQ
wQ
wQ
wQ
wQ
wQ
wQ
"}
(12,1,1) = {"
wQ
wQ
wQ
wQ
wQ
wQ
wQ
wQ
wQ
wQ
wQ
wQ
wQ
wQ
wQ
wQ
wQ
wQ
wQ
wQ
wQ
wQ
wQ
wQ
wQ
wQ
wQ
wQ
wQ
wQ
wQ
wQ
wQ
wQ
wQ
wQ
wQ
wQ
wQ
wQ
wQ
"}
(13,1,1) = {"
wQ
wQ
wQ
wQ
wQ
wQ
wQ
wQ
wQ
wQ
wQ
wQ
wQ
wQ
wQ
wQ
wQ
wQ
wQ
wQ
wQ
ZL
wQ
wQ
wQ
wQ
wQ
wQ
wQ
wQ
wQ
wQ
wQ
wQ
wQ
wQ
wQ
wQ
wQ
wQ
wQ
"}
(14,1,1) = {"
wQ
wQ
wQ
wQ
wQ
wQ
wQ
wQ
wQ
wQ
wQ
wQ
wQ
wQ
wQ
wQ
wQ
wQ
wQ
wQ
ZL
ZL
ZL
wQ
wQ
wQ
wQ
wQ
wQ
wQ
wQ
wQ
wQ
wQ
wQ
wQ
wQ
wQ
wQ
wQ
wQ
"}
(15,1,1) = {"
wQ
wQ
wQ
wQ
wQ
wQ
wQ
wQ
wQ
wQ
wQ
wQ
wQ
wQ
wQ
wQ
wQ
wQ
wQ
wQ
ZL
kt
ZL
ZL
wQ
wQ
wQ
wQ
wQ
wQ
wQ
wQ
wQ
wQ
wQ
wQ
wQ
wQ
wQ
wQ
wQ
"}
(16,1,1) = {"
wQ
wQ
wQ
wQ
wQ
wQ
wQ
ZL
fH
fH
fH
fH
fH
cg
cg
cg
cg
cg
cg
cg
XD
By
xu
cg
cg
cg
fH
wQ
wQ
wQ
wQ
wQ
wQ
wQ
wQ
wQ
wQ
wQ
wQ
wQ
wQ
"}
(17,1,1) = {"
wQ
wQ
wQ
wQ
wQ
wQ
ZL
ZL
fH
xJ
xJ
xJ
xJ
cg
BS
BS
cg
GD
GF
cg
ZL
ZL
ZL
fn
op
xG
cg
fH
wQ
wQ
wQ
wQ
wQ
wQ
wQ
wQ
wQ
wQ
wQ
wQ
wQ
"}
(18,1,1) = {"
wQ
wQ
wQ
wQ
wQ
wQ
ZL
ZL
fH
Vd
Dr
xJ
qc
cg
vg
Lx
cg
vW
AB
cg
ZL
hq
ZL
ZL
Yv
AB
cg
cg
fH
wQ
wQ
wQ
wQ
wQ
wQ
wQ
wQ
wQ
wQ
wQ
wQ
"}
(19,1,1) = {"
wQ
wQ
wQ
wQ
wQ
wQ
wQ
ZL
YK
ZL
dj
xJ
Hk
IS
Lx
ro
Ek
Lx
AB
vR
ZL
Yv
ZL
Yv
Yv
AB
cg
cg
cg
fH
wQ
wQ
wQ
wQ
wQ
wQ
wQ
wQ
wQ
wQ
wQ
"}
(20,1,1) = {"
wQ
wQ
wQ
wQ
wQ
wQ
wQ
ZL
XD
kt
wM
wM
Gy
cg
vg
Lx
cg
AB
AB
cg
Yv
Yv
Yv
cg
Lx
AB
cg
cg
cg
cg
fH
wQ
wQ
wQ
wQ
wQ
wQ
wQ
wQ
wQ
wQ
"}
(21,1,1) = {"
wQ
wQ
wQ
wQ
wQ
wQ
wQ
wQ
xu
ZL
wM
wM
uX
cg
cg
IS
cg
cg
cg
cg
AB
AB
cg
cg
AB
AB
cg
cg
cg
cg
fH
wQ
wQ
wQ
wQ
wQ
wQ
wQ
wQ
wQ
wQ
"}
(22,1,1) = {"
wQ
wQ
wQ
wQ
wQ
wQ
wQ
ZL
By
By
hq
dj
uX
cg
uE
Lx
OQ
qL
OQ
zk
AB
AB
FP
cg
Pl
Yv
cg
CI
hq
Td
fH
hn
wQ
wQ
wQ
wQ
wQ
wQ
wQ
wQ
wQ
"}
(23,1,1) = {"
wQ
wQ
wQ
wQ
wQ
wQ
wQ
wQ
ua
fr
ZL
wM
lO
cg
Pk
AB
AB
Lx
AB
wv
Lx
AB
FP
cg
Yv
Yv
TO
hq
ZL
hq
Pi
ZL
ZL
wQ
wQ
wQ
wQ
wQ
wQ
wQ
wQ
"}
(24,1,1) = {"
wQ
wQ
wQ
wQ
wQ
wQ
wQ
ZL
ZL
ZL
By
IH
wM
cg
br
Lx
OQ
Vi
OQ
Zu
AB
AB
FP
cg
gP
Yv
cg
hn
ZL
Td
fH
hn
wQ
wQ
wQ
wQ
wQ
wQ
wQ
wQ
wQ
"}
(25,1,1) = {"
wQ
wQ
wQ
wQ
wQ
wQ
ZL
ZL
xu
ZL
fr
Fi
mb
cg
cg
IS
cg
cg
cg
cg
AB
Lx
lS
cg
cg
cg
cg
cg
cg
cg
fH
wQ
wQ
wQ
wQ
wQ
wQ
wQ
wQ
wQ
wQ
"}
(26,1,1) = {"
wQ
wQ
wQ
wQ
wQ
wQ
wQ
ZL
By
ZL
By
WC
mb
cg
bI
AB
Lx
AB
oS
cg
cg
IS
cg
cg
ib
eb
cg
cg
cg
cg
fH
wQ
wQ
wQ
wQ
wQ
wQ
wQ
wQ
wQ
wQ
"}
(27,1,1) = {"
wQ
wQ
wQ
wQ
wQ
wQ
wQ
wQ
ua
ZL
ZL
ZL
mb
cg
Tb
AB
KT
AB
Lx
IS
AB
AB
AB
IS
AB
Lx
cg
cg
cg
fH
wQ
wQ
wQ
wQ
wQ
wQ
wQ
wQ
wQ
wQ
wQ
"}
(28,1,1) = {"
wQ
wQ
wQ
wQ
wQ
wQ
wQ
wQ
XD
fr
kt
ZL
lN
cg
tT
lJ
bX
pl
oS
cg
AB
Lx
AB
cg
cg
zW
cg
cg
fH
wQ
wQ
wQ
wQ
wQ
wQ
wQ
wQ
wQ
wQ
wQ
wQ
"}
(29,1,1) = {"
wQ
wQ
wQ
wQ
wQ
wQ
wQ
ZL
xu
ZL
By
ZL
wa
cg
uE
AB
Yr
qM
Ih
cg
kM
aF
eL
cg
HI
cb
cg
fH
wQ
wQ
wQ
wQ
wQ
wQ
wQ
wQ
wQ
wQ
wQ
wQ
wQ
"}
(30,1,1) = {"
wQ
wQ
wQ
wQ
wQ
wQ
wQ
ZL
ZL
YK
ZL
xu
YK
xu
cg
cg
cg
cg
cg
cg
cg
cg
cg
cg
cg
cg
fH
wQ
wQ
wQ
wQ
wQ
wQ
wQ
wQ
wQ
wQ
wQ
wQ
wQ
wQ
"}
(31,1,1) = {"
wQ
wQ
wQ
wQ
wQ
wQ
wQ
ZL
wQ
ZL
wQ
ZL
ZL
ZL
ZL
wQ
wQ
wQ
wQ
wQ
wQ
wQ
wQ
wQ
wQ
wQ
wQ
wQ
wQ
wQ
wQ
wQ
wQ
wQ
wQ
wQ
wQ
wQ
wQ
wQ
wQ
"}
(32,1,1) = {"
wQ
wQ
wQ
wQ
wQ
wQ
wQ
wQ
wQ
wQ
wQ
wQ
ZL
ZL
ZL
wQ
wQ
wQ
wQ
wQ
wQ
wQ
wQ
wQ
wQ
wQ
wQ
wQ
wQ
wQ
wQ
wQ
wQ
wQ
wQ
wQ
wQ
wQ
wQ
wQ
wQ
"}
(33,1,1) = {"
wQ
wQ
wQ
wQ
wQ
wQ
wQ
wQ
wQ
wQ
wQ
wQ
wQ
wQ
wQ
wQ
wQ
wQ
wQ
wQ
wQ
wQ
wQ
wQ
wQ
wQ
wQ
wQ
wQ
wQ
wQ
wQ
wQ
wQ
wQ
wQ
wQ
wQ
wQ
wQ
wQ
"}
(34,1,1) = {"
wQ
wQ
wQ
wQ
wQ
wQ
wQ
wQ
wQ
wQ
wQ
wQ
wQ
wQ
wQ
wQ
wQ
wQ
wQ
wQ
wQ
wQ
wQ
wQ
wQ
wQ
wQ
wQ
wQ
wQ
wQ
wQ
wQ
wQ
wQ
wQ
wQ
wQ
wQ
wQ
wQ
"}
(35,1,1) = {"
wQ
wQ
wQ
wQ
wQ
wQ
wQ
wQ
wQ
wQ
wQ
wQ
wQ
wQ
wQ
wQ
wQ
wQ
wQ
wQ
wQ
wQ
wQ
wQ
wQ
wQ
wQ
wQ
wQ
wQ
wQ
wQ
wQ
wQ
wQ
wQ
wQ
wQ
wQ
wQ
wQ
"}
(36,1,1) = {"
wQ
wQ
wQ
wQ
wQ
wQ
wQ
wQ
wQ
wQ
wQ
wQ
wQ
wQ
wQ
wQ
wQ
wQ
wQ
wQ
wQ
wQ
wQ
wQ
wQ
wQ
wQ
wQ
wQ
wQ
wQ
wQ
wQ
wQ
wQ
wQ
wQ
wQ
wQ
wQ
wQ
"}
(37,1,1) = {"
wQ
wQ
wQ
wQ
wQ
wQ
wQ
wQ
wQ
wQ
wQ
wQ
wQ
wQ
wQ
wQ
wQ
wQ
wQ
wQ
wQ
wQ
wQ
wQ
wQ
wQ
wQ
wQ
wQ
wQ
wQ
wQ
wQ
wQ
wQ
wQ
wQ
wQ
wQ
wQ
wQ
"}
(38,1,1) = {"
wQ
wQ
wQ
wQ
wQ
wQ
wQ
wQ
wQ
wQ
wQ
wQ
wQ
wQ
wQ
wQ
wQ
wQ
wQ
wQ
wQ
wQ
wQ
wQ
wQ
wQ
wQ
wQ
wQ
wQ
wQ
wQ
wQ
wQ
wQ
wQ
wQ
wQ
wQ
wQ
wQ
"}
(39,1,1) = {"
wQ
wQ
wQ
wQ
wQ
wQ
wQ
wQ
wQ
wQ
wQ
wQ
wQ
wQ
wQ
wQ
wQ
wQ
wQ
wQ
wQ
wQ
wQ
wQ
wQ
wQ
wQ
wQ
wQ
wQ
wQ
wQ
wQ
wQ
wQ
wQ
wQ
wQ
wQ
wQ
wQ
"}
(40,1,1) = {"
wQ
wQ
wQ
wQ
wQ
wQ
wQ
wQ
wQ
wQ
wQ
wQ
wQ
wQ
wQ
wQ
wQ
wQ
wQ
wQ
wQ
wQ
wQ
wQ
wQ
wQ
wQ
wQ
wQ
wQ
wQ
wQ
wQ
wQ
wQ
wQ
wQ
wQ
wQ
wQ
wQ
"}
(41,1,1) = {"
wQ
wQ
wQ
wQ
wQ
wQ
wQ
wQ
wQ
wQ
wQ
wQ
wQ
wQ
wQ
wQ
wQ
wQ
wQ
wQ
wQ
wQ
wQ
wQ
wQ
wQ
wQ
wQ
wQ
wQ
wQ
wQ
wQ
wQ
wQ
wQ
wQ
wQ
wQ
wQ
wQ
"}
(42,1,1) = {"
wQ
wQ
wQ
wQ
wQ
wQ
wQ
wQ
wQ
wQ
wQ
wQ
wQ
wQ
wQ
wQ
wQ
wQ
wQ
wQ
wQ
wQ
wQ
wQ
wQ
wQ
wQ
wQ
wQ
wQ
wQ
wQ
wQ
wQ
wQ
wQ
wQ
wQ
wQ
wQ
wQ
"}
(43,1,1) = {"
wQ
wQ
wQ
wQ
wQ
wQ
wQ
wQ
wQ
wQ
wQ
wQ
wQ
wQ
wQ
wQ
wQ
wQ
wQ
wQ
wQ
wQ
wQ
wQ
wQ
wQ
wQ
wQ
wQ
wQ
wQ
wQ
wQ
wQ
wQ
wQ
wQ
wQ
wQ
wQ
wQ
"}
(44,1,1) = {"
wQ
wQ
wQ
wQ
wQ
wQ
wQ
wQ
wQ
wQ
wQ
wQ
wQ
wQ
wQ
wQ
wQ
wQ
wQ
wQ
wQ
wQ
wQ
wQ
wQ
wQ
wQ
wQ
wQ
wQ
wQ
wQ
wQ
wQ
wQ
wQ
wQ
wQ
wQ
wQ
wQ
"}
