//MAP CONVERTED BY dmm2tgm.py THIS HEADER COMMENT PREVENTS RECONVERSION, DO NOT REMOVE
"ar" = (
/obj/structure/railing,
/obj/decal/cleanable/dirt,
/turf/simulated/floor/exoplanet/concrete,
/area/map_template/garage)
"aF" = (
/obj/structure/aurora/informative/wall_computer/garage{
	pixel_y = 32
	},
/obj/floor_decal/snow,
/turf/simulated/floor/exoplanet/concrete,
/area/map_template/garage)
"bi" = (
/obj/floor_decal/industrial/warning/dust/corner,
/obj/floor_decal/snow,
/turf/simulated/floor/exoplanet/concrete,
/area/map_template/garage)
"br" = (
/obj/anomaly/electra/three_and_three/tesla,
/obj/structure/aurora/old_comp,
/turf/simulated/floor/exoplanet/snow,
/area/template_noop)
"bI" = (
/obj/structure/aurora/old_comp,
/obj/floor_decal/snow,
/turf/simulated/floor/holofloor/tiled,
/area/map_template/garage/first_home)
"bX" = (
/obj/structure/ice_rock,
/obj/structure/railing/mapped{
	dir = 8
	},
/turf/simulated/floor/exoplanet/ice,
/area/template_noop)
"cb" = (
/obj/floor_decal/snow,
/obj/structure/table/rack/dark,
/turf/simulated/floor/holofloor/tiled,
/area/map_template/garage/first_home)
"cc" = (
/turf/simulated/wall/titanium,
/area/map_template/garage)
"cg" = (
/obj/floor_decal/snow,
/obj/forcefield/blocker,
/turf/simulated/floor/exoplanet/concrete/reinforced,
/area/map_template/garage)
"cm" = (
/obj/floor_decal/industrial/warning/dust{
	dir = 8
	},
/obj/floor_decal/snow,
/turf/simulated/floor/exoplanet/concrete,
/area/map_template/garage)
"dk" = (
/obj/floor_decal/snow,
/turf/simulated/floor/exoplanet/concrete/reinforced,
/area/map_template/garage)
"eb" = (
/obj/structure/grille/broken,
/turf/simulated/floor/exoplanet/ice,
/area/template_noop)
"eL" = (
/obj/structure/table/steel_reinforced,
/obj/item/device/flashlight/lamp,
/obj/decal/cleanable/dirt,
/turf/simulated/floor/exoplanet/concrete,
/area/map_template/garage)
"fa" = (
/obj/structure/table/steel_reinforced,
/obj/item/stock_parts/computer/scanner/paper,
/obj/decal/cleanable/dirt,
/turf/simulated/floor/exoplanet/concrete,
/area/map_template/garage)
"fi" = (
/obj/floor_decal/industrial/warning/dust{
	dir = 8
	},
/obj/decal/cleanable/dirt,
/turf/simulated/floor/exoplanet/concrete,
/area/map_template/garage)
"fn" = (
/obj/floor_decal/snow,
/obj/structure/aurora/wall_light{
	dir = 4
	},
/obj/item/clothing/under/rank/miner,
/turf/simulated/floor/exoplanet/concrete,
/area/map_template/garage)
"fr" = (
/turf/simulated/floor/exoplanet/ice,
/area/template_noop)
"fD" = (
/obj/machinery/door/blast/regular{
	id_tag = "35"
	},
/obj/floor_decal/industrial/warning/fulltile,
/turf/simulated/floor/exoplanet/concrete/reinforced,
/area/map_template/garage)
"fH" = (
/obj/structure/ice_rock,
/obj/structure/railing/mapped,
/turf/simulated/floor/exoplanet/ice,
/area/template_noop)
"gP" = (
/obj/structure/aurora/nav_light,
/turf/simulated/floor/exoplanet/snow,
/area/template_noop)
"hn" = (
/obj/structure/aurora/wall_light{
	dir = 1
	},
/turf/template_noop,
/area/template_noop)
"hq" = (
/obj/structure/aurora/wall_light{
	dir = 1
	},
/turf/simulated/floor/exoplanet/ice,
/area/template_noop)
"ib" = (
/obj/floor_decal/snow,
/obj/floor_decal/snow,
/obj/structure/aurora/wall_light{
	dir = 8
	},
/turf/simulated/floor/holofloor/tiled,
/area/map_template/garage/second_home)
"iu" = (
/obj/floor_decal/industrial/warning/dust,
/obj/floor_decal/snow,
/turf/simulated/floor/exoplanet/concrete,
/area/map_template/garage)
"kt" = (
/obj/anomaly/electra/three_and_three/tesla_second,
/turf/simulated/floor/exoplanet/snow,
/area/template_noop)
"kM" = (
/obj/structure/broken_cryo,
/obj/floor_decal/snow,
/obj/structure/aurora/wall_light{
	dir = 4
	},
/turf/simulated/floor/holofloor/tiled,
/area/map_template/garage/second_home)
"lJ" = (
/obj/floor_decal/snow,
/obj/floor_decal/snow,
/turf/simulated/floor/exoplanet/concrete/reinforced,
/area/map_template/garage)
"lN" = (
/obj/structure/aurora/cable_angle{
	dir = 1
	},
/turf/simulated/floor/exoplanet/ice,
/area/template_noop)
"lO" = (
/obj/floor_decal/snow,
/obj/decal/cleanable/ash,
/obj/structure/aurora/wall_light,
/turf/simulated/floor/holofloor/tiled,
/area/map_template/garage/first_home)
"lS" = (
/turf/simulated/floor/exoplanet/concrete,
/area/template_noop)
"mb" = (
/obj/structure/broken_cryo,
/turf/simulated/floor/exoplanet/snow,
/area/template_noop)
"ng" = (
/obj/structure/aurora/wall_light{
	dir = 1
	},
/obj/structure/aurora/smes,
/turf/simulated/floor/exoplanet/concrete,
/area/map_template/garage)
"nN" = (
/obj/decal/cleanable/ash,
/obj/decal/cleanable/dirt,
/turf/simulated/floor/exoplanet/concrete,
/area/template_noop)
"op" = (
/obj/floor_decal/snow,
/turf/simulated/floor/exoplanet/concrete,
/area/map_template/garage)
"os" = (
/obj/structure/pit/closed,
/obj/landmark/corpse/miningstation/deadmineroveralls,
/turf/simulated/floor/exoplanet/snow,
/area/template_noop)
"oS" = (
/turf/simulated/mineral/ice,
/area/template_noop)
"pl" = (
/obj/floor_decal/snow,
/obj/structure/aurora/smes,
/turf/simulated/floor/exoplanet/concrete,
/area/map_template/garage)
"qc" = (
/obj/structure/ice_rock,
/turf/simulated/floor/exoplanet/ice,
/area/template_noop)
"qL" = (
/obj/structure/destroyed_apc{
	layer = 5
	},
/obj/decal/cleanable/dirt,
/turf/simulated/floor/exoplanet/concrete/reinforced,
/area/map_template/garage)
"qM" = (
/obj/floor_decal/snow,
/obj/structure/broken_cryo{
	dir = 4
	},
/turf/simulated/floor/holofloor/tiled,
/area/map_template/garage/first_home)
"rg" = (
/obj/floor_decal/industrial/loading,
/obj/decal/cleanable/dirt,
/turf/simulated/floor/exoplanet/concrete/reinforced,
/area/map_template/garage)
"rp" = (
/obj/structure/closet/secure_closet/miner,
/obj/floor_decal/industrial/outline/red,
/obj/floor_decal/snow,
/turf/simulated/floor/holofloor/tiled,
/area/map_template/garage/second_home)
"tM" = (
/obj/random/junk,
/obj/floor_decal/industrial/warning/dust{
	dir = 4
	},
/obj/decal/cleanable/dirt,
/turf/simulated/floor/exoplanet/concrete,
/area/map_template/garage)
"tT" = (
/obj/structure/aurora/smes,
/turf/simulated/floor/exoplanet/snow,
/area/template_noop)
"ua" = (
/obj/structure/railing/mapped{
	dir = 4
	},
/turf/simulated/floor/exoplanet/ice,
/area/template_noop)
"uE" = (
/obj/structure/aurora/old_comp,
/turf/simulated/floor/exoplanet/snow,
/area/template_noop)
"uM" = (
/obj/floor_decal/industrial/warning/dust{
	dir = 4
	},
/obj/structure/railing{
	dir = 8
	},
/obj/decal/cleanable/dirt,
/turf/simulated/floor/exoplanet/concrete,
/area/map_template/garage)
"uX" = (
/obj/structure/sign/science_2{
	pixel_y = -32
	},
/turf/template_noop,
/area/template_noop)
"vg" = (
/obj/floor_decal/snow,
/obj/structure/aurora/old_comp,
/turf/simulated/floor/holofloor/tiled,
/area/map_template/garage/first_home)
"vR" = (
/obj/structure/aurora/cable{
	dir = 1
	},
/turf/simulated/floor/exoplanet/ice,
/area/template_noop)
"wa" = (
/obj/structure/broken_cryo{
	dir = 4
	},
/obj/structure/aurora/wall_light{
	dir = 1
	},
/obj/floor_decal/snow,
/turf/simulated/floor/holofloor/tiled,
/area/map_template/garage/first_home)
"wn" = (
/obj/random/junk,
/obj/decal/cleanable/dirt,
/turf/simulated/floor/exoplanet/concrete/reinforced,
/area/map_template/garage)
"wr" = (
/obj/decal/cleanable/blood/oil,
/obj/decal/cleanable/dirt,
/turf/simulated/floor/exoplanet/concrete/reinforced,
/area/map_template/garage)
"wv" = (
/obj/floor_decal/snow,
/obj/structure/aurora/smes,
/turf/simulated/floor/holofloor/tiled,
/area/map_template/garage/second_home)
"wQ" = (
/turf/template_noop,
/area/template_noop)
"xu" = (
/obj/anomaly/electra/three_and_three/tesla_second,
/obj/floor_decal/corner/yellow/mono,
/turf/simulated/floor/exoplanet/concrete,
/area/template_noop)
"xz" = (
/obj/structure/pit,
/obj/landmark/corpse/miningstation/deadminerf,
/turf/simulated/floor/exoplanet/snow,
/area/template_noop)
"xG" = (
/obj/decal/cleanable/dirt,
/turf/simulated/floor/exoplanet/concrete,
/area/map_template/garage)
"xJ" = (
/turf/simulated/wall/titanium,
/area/map_template/garage/second_home)
"ys" = (
/obj/floor_decal/industrial/warning{
	dir = 9
	},
/obj/structure/reagent_dispensers/fueltank,
/turf/simulated/floor/exoplanet/concrete,
/area/map_template/garage)
"yE" = (
/obj/floor_decal/industrial/warning/dust{
	dir = 4
	},
/obj/floor_decal/snow,
/obj/structure/railing{
	dir = 8
	},
/turf/simulated/floor/exoplanet/concrete,
/area/map_template/garage)
"zc" = (
/obj/floor_decal/snow,
/turf/simulated/floor/holofloor/tiled,
/area/map_template/garage/second_home)
"zk" = (
/obj/item/material/shard/shrapnel/aluminium,
/turf/simulated/floor/exoplanet/ice,
/area/template_noop)
"zV" = (
/obj/decal/cleanable/dirt,
/turf/simulated/floor/exoplanet/concrete,
/area/template_noop)
"zW" = (
/obj/item/material/shard/shrapnel/aluminium,
/obj/decal/cleanable/dirt,
/turf/simulated/floor/exoplanet/concrete,
/area/template_noop)
"AB" = (
/obj/structure/railing/mapped{
	dir = 8
	},
/turf/simulated/mineral/ice,
/area/template_noop)
"Ba" = (
/obj/item/remains/human,
/turf/simulated/floor/exoplanet/snow,
/area/template_noop)
"Bc" = (
/obj/floor_decal/snow,
/obj/item/storage/toolbox/mechanical{
	pixel_y = 16;
	pixel_x = -8
	},
/obj/decal/cleanable/blood/oil,
/obj/structure/roller_bed{
	pixel_y = 4;
	pixel_x = -13
	},
/turf/simulated/floor/exoplanet/concrete/reinforced,
/area/map_template/garage)
"By" = (
/obj/structure/grille,
/turf/simulated/floor/exoplanet/ice,
/area/template_noop)
"BS" = (
/obj/structure/aurora/nav_light,
/obj/decal/cleanable/dirt,
/turf/simulated/floor/exoplanet/concrete,
/area/template_noop)
"CI" = (
/obj/floor_decal/snow,
/obj/structure/aurora/old_comp,
/turf/simulated/floor/holofloor/tiled,
/area/map_template/garage/second_home)
"Ek" = (
/turf/simulated/wall/titanium,
/area/map_template/garage/first_home)
"Eo" = (
/obj/structure/ice_rock,
/obj/structure/grille/broken,
/turf/simulated/floor/exoplanet/ice,
/area/template_noop)
"Ew" = (
/obj/decal/cleanable/dirt,
/turf/simulated/floor/exoplanet/concrete/reinforced,
/area/map_template/garage)
"EQ" = (
/obj/structure/table/rack/dark,
/obj/item/pickaxe/drill,
/turf/simulated/floor/exoplanet/snow,
/area/template_noop)
"Fi" = (
/obj/structure/aurora/smes,
/turf/simulated/floor/exoplanet/concrete,
/area/map_template/garage)
"Fn" = (
/obj/decal/cleanable/ash,
/turf/simulated/floor/exoplanet/snow,
/area/template_noop)
"FP" = (
/obj/floor_decal/snow,
/obj/random/junk,
/turf/simulated/floor/exoplanet/concrete,
/area/map_template/garage)
"FZ" = (
/obj/floor_decal/snow,
/obj/item/archaeological_find/remains/xeno,
/turf/simulated/floor/exoplanet/concrete,
/area/map_template/garage)
"Gy" = (
/obj/structure/disposalpipe/broken,
/turf/template_noop,
/area/template_noop)
"GD" = (
/obj/structure/broken_door,
/obj/floor_decal/industrial/warning/fulltile,
/obj/floor_decal/snow,
/turf/unsimulated/floor/tile,
/area/map_template/garage/second_home)
"GF" = (
/obj/structure/table/rack/dark,
/obj/structure/aurora/wall_light{
	dir = 8
	},
/turf/simulated/floor/exoplanet/concrete,
/area/map_template/garage)
"Hd" = (
/obj/structure/aurora/cable_angle,
/turf/simulated/floor/exoplanet/ice,
/area/template_noop)
"Hk" = (
/obj/structure/aurora/wall_light{
	dir = 1
	},
/obj/floor_decal/snow,
/turf/simulated/floor/exoplanet/concrete,
/area/map_template/garage)
"HI" = (
/obj/structure/aurora/wall_light{
	dir = 4
	},
/turf/simulated/floor/exoplanet/ice,
/area/template_noop)
"Ih" = (
/obj/floor_decal/snow,
/obj/random/junk,
/obj/forcefield/blocker,
/turf/simulated/floor/exoplanet/concrete/reinforced,
/area/map_template/garage)
"IH" = (
/obj/item/weldingtool/electric,
/obj/floor_decal/industrial/warning/dust{
	dir = 4
	},
/obj/decal/cleanable/dirt,
/turf/simulated/floor/exoplanet/concrete,
/area/map_template/garage)
"IS" = (
/obj/floor_decal/snow,
/obj/item/remains/human,
/turf/simulated/floor/holofloor/tiled,
/area/map_template/garage/first_home)
"Jo" = (
/obj/floor_decal/snow,
/obj/random/junk,
/obj/decal/cleanable/blood/oil,
/turf/simulated/floor/exoplanet/concrete/reinforced,
/area/map_template/garage)
"Kc" = (
/obj/random/junk,
/obj/floor_decal/snow,
/turf/simulated/floor/exoplanet/concrete/reinforced,
/area/map_template/garage)
"KT" = (
/obj/floor_decal/snow,
/turf/simulated/floor/holofloor/tiled,
/area/map_template/garage/first_home)
"Ls" = (
/obj/floor_decal/snow,
/turf/simulated/floor/exoplanet/concrete,
/area/template_noop)
"Lx" = (
/obj/structure/ice_rock,
/turf/simulated/floor/exoplanet/snow,
/area/template_noop)
"LQ" = (
/obj/floor_decal/industrial/warning/dust{
	dir = 4
	},
/obj/decal/cleanable/dirt,
/turf/simulated/floor/exoplanet/concrete,
/area/map_template/garage)
"MW" = (
/obj/floor_decal/industrial/warning/dust{
	dir = 4
	},
/obj/structure/bed/chair/comfy/brown{
	dir = 7
	},
/obj/decal/cleanable/dirt,
/turf/simulated/floor/exoplanet/concrete,
/area/map_template/garage)
"Nc" = (
/obj/structure/table/steel_reinforced,
/obj/structure/aurora/wall_light{
	dir = 8
	},
/obj/decal/cleanable/dirt,
/turf/simulated/floor/exoplanet/concrete,
/area/map_template/garage)
"Nd" = (
/obj/machinery/door/blast/regular/open{
	dir = 4
	},
/obj/floor_decal/industrial/warning/fulltile,
/turf/simulated/floor/exoplanet/concrete,
/area/map_template/garage)
"Nl" = (
/obj/floor_decal/industrial/warning/dust{
	dir = 8
	},
/obj/machinery/button/blast_door{
	dir = 1;
	pixel_y = -23;
	id_tag = "35"
	},
/obj/decal/cleanable/dirt,
/turf/simulated/floor/exoplanet/concrete,
/area/map_template/garage)
"OP" = (
/obj/floor_decal/industrial/warning{
	dir = 1
	},
/obj/structure/reagent_dispensers/fueltank,
/turf/simulated/floor/exoplanet/concrete,
/area/map_template/garage)
"OQ" = (
/obj/floor_decal/snow,
/obj/decal/cleanable/ash,
/turf/simulated/floor/holofloor/tiled,
/area/map_template/garage/first_home)
"OR" = (
/obj/floor_decal/industrial/outline/orange,
/obj/structure/railing{
	dir = 1
	},
/obj/structure/reagent_dispensers/water_cooler,
/obj/decal/cleanable/dirt,
/turf/simulated/floor/exoplanet/concrete,
/area/map_template/garage)
"Pi" = (
/obj/machinery/door/blast/shutters,
/turf/simulated/floor/exoplanet/snow,
/area/template_noop)
"Pk" = (
/obj/structure/aurora/wall_light{
	dir = 1
	},
/obj/structure/broken_cryo{
	dir = 4
	},
/obj/floor_decal/snow,
/turf/simulated/floor/holofloor/tiled,
/area/map_template/garage/first_home)
"Pl" = (
/obj/decal/cleanable/ash,
/turf/simulated/floor/exoplanet/concrete,
/area/template_noop)
"PP" = (
/obj/machinery/mining/brace,
/turf/simulated/floor/exoplanet/snow,
/area/template_noop)
"Qa" = (
/obj/structure/aurora/wall_light{
	dir = 8
	},
/obj/item/material/drill_head/steel,
/obj/item/material/drill_head/steel,
/obj/structure/table/rack/dark,
/turf/simulated/floor/exoplanet/snow,
/area/template_noop)
"QQ" = (
/obj/structure/cart{
	dir = 8
	},
/obj/structure/aurora/wall_light{
	dir = 8
	},
/obj/floor_decal/industrial/outline/orange,
/obj/decal/cleanable/dirt,
/turf/simulated/floor/exoplanet/concrete,
/area/map_template/garage)
"QU" = (
/obj/machinery/power/port_gen/pacman/mrs,
/turf/simulated/floor/exoplanet/snow,
/area/template_noop)
"Rg" = (
/obj/floor_decal/industrial/outline/orange,
/obj/decal/cleanable/dirt,
/turf/simulated/floor/exoplanet/concrete,
/area/map_template/garage)
"Ry" = (
/obj/structure/pit,
/obj/landmark/corpse/miningstation/deadminersuit,
/turf/simulated/floor/exoplanet/snow,
/area/template_noop)
"SN" = (
/obj/random/junk,
/obj/structure/aurora/wall_light{
	dir = 4
	},
/obj/decal/cleanable/dirt,
/turf/simulated/floor/exoplanet/concrete,
/area/map_template/garage)
"Tb" = (
/obj/structure/broken_cryo{
	dir = 4
	},
/turf/simulated/floor/exoplanet/snow,
/area/template_noop)
"Td" = (
/obj/structure/sign/science_2{
	pixel_y = 32
	},
/turf/template_noop,
/area/template_noop)
"TO" = (
/obj/structure/ice_rock,
/obj/structure/railing/mapped{
	dir = 1
	},
/turf/simulated/floor/exoplanet/ice,
/area/template_noop)
"TX" = (
/obj/floor_decal/snow,
/obj/decal/cleanable/ash,
/turf/simulated/floor/holofloor/tiled,
/area/map_template/garage/second_home)
"UL" = (
/obj/structure/closet/toolcloset,
/obj/floor_decal/industrial/outline/orange,
/obj/decal/cleanable/dirt,
/turf/simulated/floor/exoplanet/concrete,
/area/map_template/garage)
"Vi" = (
/obj/structure/broken_door,
/obj/floor_decal/industrial/warning/fulltile,
/obj/floor_decal/snow,
/turf/simulated/floor/exoplanet/snow,
/area/template_noop)
"VA" = (
/obj/machinery/mining/drill,
/obj/floor_decal/industrial/outline/yellow,
/obj/floor_decal/snow,
/turf/simulated/floor/holofloor/tiled,
/area/map_template/garage/second_home)
"Wm" = (
/obj/structure/aurora/wall_light{
	dir = 4
	},
/obj/item/stock_parts/circuitboard/miningdrillbrace,
/obj/machinery/constructable_frame,
/obj/floor_decal/industrial/outline/yellow,
/obj/floor_decal/snow,
/turf/simulated/floor/holofloor/tiled,
/area/map_template/garage/second_home)
"WC" = (
/obj/structure/grille/broken,
/obj/structure/ice_rock,
/turf/simulated/floor/exoplanet/snow,
/area/template_noop)
"Xh" = (
/obj/floor_decal/snow,
/obj/decal/cleanable/blood/oil,
/turf/simulated/floor/exoplanet/concrete/reinforced,
/area/map_template/garage)
"XD" = (
/obj/structure/grille/broken,
/turf/simulated/floor/exoplanet/snow,
/area/template_noop)
"XN" = (
/obj/structure/table/rack/dark,
/turf/simulated/floor/exoplanet/snow,
/area/template_noop)
"Yr" = (
/obj/structure/table/rack/dark,
/obj/item/storage/toolbox/mechanical,
/turf/simulated/floor/exoplanet/concrete,
/area/map_template/garage)
"YK" = (
/obj/structure/railing/mapped,
/turf/simulated/floor/exoplanet/ice,
/area/template_noop)
"Zu" = (
/obj/machinery/door/blast/regular,
/obj/floor_decal/industrial/warning/fulltile,
/turf/simulated/floor/exoplanet/concrete/reinforced,
/area/map_template/garage)
"ZL" = (
/turf/simulated/floor/exoplanet/snow,
/area/template_noop)

(1,1,1) = {"
wQ
wQ
wQ
wQ
wQ
wQ
wQ
cc
cc
cc
cc
cc
cc
cc
cc
cc
cc
cc
cc
cc
wQ
wQ
"}
(2,1,1) = {"
wQ
wQ
wQ
wQ
wQ
wQ
wQ
cc
Fi
ar
GF
Yr
OR
UL
QQ
Rg
eL
Nc
fa
cc
wQ
wQ
"}
(3,1,1) = {"
wQ
wQ
wQ
wQ
wQ
wQ
wQ
cc
ng
bi
yE
uM
IH
LQ
LQ
tM
LQ
MW
LQ
cc
hn
wQ
"}
(4,1,1) = {"
wQ
wQ
wQ
wQ
wQ
wQ
uX
cc
Fi
iu
Kc
dk
wr
wn
Xh
qL
wn
wr
Ew
Zu
wQ
wQ
"}
(5,1,1) = {"
wQ
wQ
wQ
wQ
wQ
wQ
wQ
cc
pl
iu
Xh
Xh
cg
cg
cg
cg
Ew
Ew
rg
Zu
wQ
wQ
"}
(6,1,1) = {"
wQ
wQ
wQ
wQ
wQ
wQ
wQ
cc
aF
iu
lJ
dk
Ih
cg
cg
cg
Ew
Ew
rg
Zu
wQ
wQ
"}
(7,1,1) = {"
wQ
wQ
wQ
wQ
wQ
wQ
wQ
cc
Hk
ZL
ZL
ZL
ZL
Xh
Bc
Jo
Xh
wn
Ew
fD
wQ
wQ
"}
(8,1,1) = {"
wQ
wQ
wQ
wQ
wQ
wQ
wQ
cc
ZL
ZL
ZL
ZL
ZL
ZL
cm
cm
cm
fi
Nl
cc
hn
wQ
"}
(9,1,1) = {"
wQ
wQ
wQ
wQ
wQ
wQ
wQ
oS
oS
oS
ZL
oS
ZL
op
FP
op
op
xG
ys
cc
wQ
wQ
"}
(10,1,1) = {"
wQ
wQ
wQ
wQ
wQ
wQ
oS
oS
oS
oS
oS
oS
fn
FZ
xG
xG
SN
xG
OP
cc
wQ
wQ
"}
(11,1,1) = {"
wQ
wQ
wQ
wQ
wQ
wQ
oS
oS
oS
fr
oS
cc
cc
Nd
Nd
cc
cc
cc
cc
cc
oS
wQ
"}
(12,1,1) = {"
wQ
wQ
Ek
Ek
Ek
Ek
Ek
oS
vR
vR
vR
lN
fr
fr
zV
fr
fr
fr
oS
oS
oS
oS
"}
(13,1,1) = {"
wQ
Gy
Ek
vg
KT
QU
Ek
fr
fr
zk
fr
fr
fr
qc
zW
ua
fr
qc
oS
oS
oS
wQ
"}
(14,1,1) = {"
wQ
uX
Ek
qM
KT
cb
Ek
fr
fH
gP
ZL
zV
zV
zV
lS
lS
gP
oS
oS
By
wQ
wQ
"}
(15,1,1) = {"
wQ
wQ
Ek
uE
ZL
ZL
Ek
fr
zk
ZL
nN
ZL
ZL
nN
lS
xu
lS
fr
fr
By
wQ
wQ
"}
(16,1,1) = {"
wQ
wQ
Ek
Pk
IS
lO
Ek
hq
fr
zV
zV
zV
ZL
ZL
Pl
lS
lS
fr
fr
Pi
wQ
wQ
"}
(17,1,1) = {"
wQ
ZL
ZL
br
Lx
OQ
Vi
Ls
oS
lS
ZL
Pl
ZL
zV
zV
zV
zV
TO
fr
Pi
wQ
wQ
"}
(18,1,1) = {"
ZL
ZL
Ek
wa
IS
lO
Ek
oS
oS
ZL
kt
lS
zV
nN
ZL
zV
nN
fr
fr
Pi
wQ
wQ
"}
(19,1,1) = {"
wQ
ZL
Ek
bI
KT
XN
Ek
oS
oS
lS
lS
lS
zV
zV
ZL
ZL
ZL
fr
fr
By
oS
wQ
"}
(20,1,1) = {"
wQ
wQ
WC
Tb
ZL
KT
Ek
fr
YK
BS
zV
zV
zV
zV
zV
ZL
Lx
zk
fr
Eo
oS
oS
"}
(21,1,1) = {"
wQ
ZL
XD
tT
ZL
Lx
Ek
fr
fr
AB
fr
bX
fr
fr
zW
fr
zk
fr
fr
eb
oS
oS
"}
(22,1,1) = {"
wQ
wQ
WC
XD
XD
Ek
Ek
fr
oS
oS
fr
fr
fr
HI
zV
HI
fr
fr
fr
oS
oS
oS
"}
(23,1,1) = {"
wQ
fr
fr
Hd
vR
qc
vR
vR
oS
xJ
xJ
xJ
xJ
xJ
GD
xJ
xJ
xJ
xJ
xJ
oS
wQ
"}
(24,1,1) = {"
wQ
wQ
wQ
fr
fr
fr
fr
oS
oS
xJ
wv
wv
ib
ZL
ZL
PP
Qa
EQ
rp
xJ
wQ
wQ
"}
(25,1,1) = {"
wQ
oS
oS
fr
qc
ZL
oS
oS
oS
xJ
zc
zc
ZL
Lx
ZL
ZL
Ba
TX
zc
xJ
wQ
wQ
"}
(26,1,1) = {"
wQ
oS
oS
oS
fr
ZL
ZL
ZL
oS
xJ
CI
kM
oS
mb
ZL
ZL
Fn
Wm
VA
xJ
Td
wQ
"}
(27,1,1) = {"
wQ
wQ
oS
oS
oS
ZL
Ry
ZL
ZL
xJ
xJ
xJ
oS
oS
XD
XD
XD
xJ
xJ
xJ
wQ
wQ
"}
(28,1,1) = {"
wQ
wQ
wQ
oS
ZL
ZL
ZL
ZL
xz
ZL
ZL
oS
oS
oS
oS
ZL
ZL
wQ
wQ
wQ
wQ
wQ
"}
(29,1,1) = {"
wQ
wQ
wQ
wQ
wQ
os
ZL
ZL
ZL
ZL
oS
oS
oS
oS
oS
oS
Lx
wQ
wQ
wQ
wQ
wQ
"}
(30,1,1) = {"
wQ
wQ
wQ
wQ
wQ
wQ
wQ
wQ
wQ
wQ
wQ
oS
oS
oS
oS
ZL
ZL
ZL
wQ
wQ
wQ
wQ
"}
(31,1,1) = {"
wQ
wQ
wQ
wQ
wQ
wQ
wQ
wQ
wQ
wQ
wQ
wQ
oS
oS
wQ
wQ
wQ
wQ
wQ
wQ
wQ
wQ
"}
