//MAP CONVERTED BY dmm2tgm.py THIS HEADER COMMENT PREVENTS RECONVERSION, DO NOT REMOVE
"aF" = (
/obj/floor_decal/snow,
/obj/structure/aurora/informative/wall_computer/garage{
	pixel_y = 32
	},
/turf/simulated/floor/exoplanet/concrete,
/area/map_template/garage)
"br" = (
/obj/anomaly/electra/three_and_three/tesla,
/obj/structure/aurora/old_comp,
/turf/simulated/floor/exoplanet/snow,
/area/template_noop)
"bI" = (
/obj/structure/aurora/old_comp,
/obj/floor_decal/snow,
/turf/simulated/floor/holofloor/tiled,
/area/map_template/garage/first_home)
"bX" = (
/obj/structure/ice_rock,
/obj/structure/railing/mapped{
	dir = 8
	},
/turf/simulated/floor/exoplanet/ice,
/area/template_noop)
"cb" = (
/obj/floor_decal/snow,
/obj/structure/table/rack/dark,
/turf/simulated/floor/holofloor/tiled,
/area/map_template/garage/first_home)
"cc" = (
/turf/simulated/wall/titanium,
/area/map_template/garage)
"cg" = (
/obj/floor_decal/snow,
/obj/forcefield/blocker,
/turf/simulated/floor/exoplanet/concrete,
/area/map_template/garage)
"eb" = (
/obj/structure/grille/broken,
/turf/simulated/floor/exoplanet/ice,
/area/template_noop)
"eL" = (
/obj/structure/table/rack/dark,
/obj/item/storage/toolbox/syndicate,
/turf/simulated/floor/exoplanet/concrete,
/area/map_template/garage)
"fn" = (
/obj/floor_decal/snow,
/obj/structure/aurora/wall_light{
	dir = 4
	},
/turf/simulated/floor/exoplanet/concrete,
/area/map_template/garage)
"fr" = (
/turf/simulated/floor/exoplanet/ice,
/area/template_noop)
"fH" = (
/obj/structure/ice_rock,
/obj/structure/railing/mapped,
/turf/simulated/floor/exoplanet/ice,
/area/template_noop)
"gP" = (
/obj/structure/aurora/nav_light,
/turf/simulated/floor/exoplanet/snow,
/area/template_noop)
"hn" = (
/obj/structure/aurora/wall_light{
	dir = 1
	},
/turf/template_noop,
/area/template_noop)
"hq" = (
/obj/structure/aurora/wall_light{
	dir = 1
	},
/turf/simulated/floor/exoplanet/ice,
/area/template_noop)
"ib" = (
/obj/floor_decal/snow,
/obj/floor_decal/snow,
/turf/simulated/floor/holofloor/tiled,
/area/map_template/garage/second_home)
"kt" = (
/obj/anomaly/electra/three_and_three/tesla_second,
/turf/simulated/floor/exoplanet/snow,
/area/template_noop)
"kM" = (
/obj/structure/broken_cryo,
/obj/floor_decal/snow,
/turf/simulated/floor/holofloor/tiled,
/area/map_template/garage/second_home)
"lJ" = (
/obj/floor_decal/snow,
/obj/floor_decal/snow,
/turf/simulated/floor/exoplanet/concrete,
/area/map_template/garage)
"lN" = (
/obj/structure/aurora/cable_angle{
	dir = 1
	},
/turf/simulated/floor/exoplanet/ice,
/area/template_noop)
"lO" = (
/obj/floor_decal/snow,
/obj/decal/cleanable/ash,
/obj/structure/aurora/wall_light,
/turf/simulated/floor/holofloor/tiled,
/area/map_template/garage/first_home)
"lS" = (
/turf/simulated/floor/exoplanet/concrete,
/area/template_noop)
"mb" = (
/obj/structure/broken_cryo,
/turf/simulated/floor/exoplanet/snow,
/area/template_noop)
"op" = (
/obj/floor_decal/snow,
/turf/simulated/floor/exoplanet/concrete,
/area/map_template/garage)
"oS" = (
/turf/simulated/mineral/ice,
/area/template_noop)
"pl" = (
/obj/structure/aurora/wall_light{
	dir = 1
	},
/turf/simulated/floor/exoplanet/concrete,
/area/map_template/garage)
"qc" = (
/obj/structure/ice_rock,
/turf/simulated/floor/exoplanet/ice,
/area/template_noop)
"qL" = (
/obj/structure/destroyed_apc{
	layer = 5
	},
/turf/simulated/floor/exoplanet/concrete,
/area/map_template/garage)
"qM" = (
/obj/floor_decal/snow,
/obj/structure/broken_cryo{
	dir = 4
	},
/turf/simulated/floor/holofloor/tiled,
/area/map_template/garage/first_home)
"rp" = (
/obj/floor_decal/snow,
/obj/structure/table/rack/dark,
/turf/simulated/floor/holofloor/tiled,
/area/map_template/garage/second_home)
"tT" = (
/obj/structure/aurora/smes,
/turf/simulated/floor/exoplanet/snow,
/area/template_noop)
"ua" = (
/obj/structure/railing/mapped{
	dir = 4
	},
/turf/simulated/floor/exoplanet/ice,
/area/template_noop)
"uE" = (
/obj/structure/aurora/old_comp,
/turf/simulated/floor/exoplanet/snow,
/area/template_noop)
"uX" = (
/obj/structure/sign/science_2{
	pixel_y = -32
	},
/turf/template_noop,
/area/template_noop)
"vg" = (
/obj/floor_decal/snow,
/obj/structure/aurora/old_comp,
/turf/simulated/floor/holofloor/tiled,
/area/map_template/garage/first_home)
"vR" = (
/obj/structure/aurora/cable{
	dir = 1
	},
/turf/simulated/floor/exoplanet/ice,
/area/template_noop)
"wa" = (
/obj/structure/broken_cryo{
	dir = 4
	},
/obj/structure/aurora/wall_light{
	dir = 1
	},
/obj/floor_decal/snow,
/turf/simulated/floor/holofloor/tiled,
/area/map_template/garage/first_home)
"wn" = (
/obj/random/junk,
/turf/simulated/floor/exoplanet/concrete,
/area/map_template/garage)
"wv" = (
/obj/floor_decal/snow,
/obj/structure/aurora/smes,
/turf/simulated/floor/holofloor/tiled,
/area/map_template/garage/second_home)
"wQ" = (
/turf/template_noop,
/area/template_noop)
"xu" = (
/obj/anomaly/electra/three_and_three/tesla_second,
/obj/floor_decal/corner/yellow/mono,
/turf/simulated/floor/exoplanet/concrete,
/area/template_noop)
"xG" = (
/turf/simulated/floor/exoplanet/concrete,
/area/map_template/garage)
"xJ" = (
/turf/simulated/wall/titanium,
/area/map_template/garage/second_home)
"zc" = (
/obj/floor_decal/snow,
/turf/simulated/floor/holofloor/tiled,
/area/map_template/garage/second_home)
"zk" = (
/obj/item/material/shard/shrapnel/aluminium,
/turf/simulated/floor/exoplanet/ice,
/area/template_noop)
"zW" = (
/obj/item/material/shard/shrapnel/aluminium,
/turf/simulated/floor/exoplanet/concrete,
/area/template_noop)
"AB" = (
/obj/structure/railing/mapped{
	dir = 8
	},
/turf/simulated/mineral/ice,
/area/template_noop)
"By" = (
/obj/structure/grille,
/turf/simulated/floor/exoplanet/ice,
/area/template_noop)
"BS" = (
/obj/structure/aurora/nav_light,
/turf/simulated/floor/exoplanet/concrete,
/area/template_noop)
"CI" = (
/obj/floor_decal/snow,
/obj/structure/aurora/old_comp,
/turf/simulated/floor/holofloor/tiled,
/area/map_template/garage/second_home)
"Ek" = (
/turf/simulated/wall/titanium,
/area/map_template/garage/first_home)
"Eo" = (
/obj/structure/ice_rock,
/obj/structure/grille/broken,
/turf/simulated/floor/exoplanet/ice,
/area/template_noop)
"Fi" = (
/obj/structure/aurora/smes,
/turf/simulated/floor/exoplanet/concrete,
/area/map_template/garage)
"FP" = (
/obj/floor_decal/snow,
/obj/random/junk,
/turf/simulated/floor/exoplanet/concrete,
/area/map_template/garage)
"Gy" = (
/obj/structure/disposalpipe/broken,
/turf/template_noop,
/area/template_noop)
"GD" = (
/obj/structure/broken_door,
/obj/floor_decal/snow,
/turf/unsimulated/floor/tile,
/area/map_template/garage/second_home)
"GF" = (
/obj/structure/table/rack/dark,
/turf/simulated/floor/exoplanet/concrete,
/area/map_template/garage)
"Hd" = (
/obj/structure/aurora/cable_angle,
/turf/simulated/floor/exoplanet/ice,
/area/template_noop)
"Hk" = (
/obj/floor_decal/snow,
/obj/structure/aurora/wall_light{
	dir = 1
	},
/turf/simulated/floor/exoplanet/concrete,
/area/map_template/garage)
"HI" = (
/obj/structure/aurora/wall_light{
	dir = 4
	},
/turf/simulated/floor/exoplanet/ice,
/area/template_noop)
"Ih" = (
/obj/floor_decal/snow,
/obj/random/junk,
/obj/forcefield/blocker,
/turf/simulated/floor/exoplanet/concrete,
/area/map_template/garage)
"IH" = (
/obj/item/weldingtool/electric,
/turf/simulated/floor/exoplanet/concrete,
/area/map_template/garage)
"IS" = (
/obj/floor_decal/snow,
/obj/item/remains/human,
/turf/simulated/floor/holofloor/tiled,
/area/map_template/garage/first_home)
"KT" = (
/obj/floor_decal/snow,
/turf/simulated/floor/holofloor/tiled,
/area/map_template/garage/first_home)
"Lx" = (
/obj/structure/ice_rock,
/turf/simulated/floor/exoplanet/snow,
/area/template_noop)
"Nd" = (
/obj/machinery/door/blast/regular,
/turf/simulated/floor/exoplanet/concrete,
/area/map_template/garage)
"OQ" = (
/obj/floor_decal/snow,
/obj/decal/cleanable/ash,
/turf/simulated/floor/holofloor/tiled,
/area/map_template/garage/first_home)
"Pi" = (
/obj/machinery/door/blast/shutters,
/turf/simulated/floor/exoplanet/snow,
/area/template_noop)
"Pk" = (
/obj/structure/aurora/wall_light{
	dir = 1
	},
/obj/structure/broken_cryo{
	dir = 4
	},
/obj/floor_decal/snow,
/turf/simulated/floor/holofloor/tiled,
/area/map_template/garage/first_home)
"Pl" = (
/obj/decal/cleanable/ash,
/turf/simulated/floor/exoplanet/concrete,
/area/template_noop)
"Tb" = (
/obj/structure/broken_cryo{
	dir = 4
	},
/turf/simulated/floor/exoplanet/snow,
/area/template_noop)
"Td" = (
/obj/structure/sign/science_2{
	pixel_y = 32
	},
/turf/template_noop,
/area/template_noop)
"TO" = (
/obj/structure/ice_rock,
/obj/structure/railing/mapped{
	dir = 1
	},
/turf/simulated/floor/exoplanet/ice,
/area/template_noop)
"UL" = (
/obj/structure/table/rack/dark,
/obj/item/storage/toolbox/electrical,
/turf/simulated/floor/exoplanet/concrete,
/area/map_template/garage)
"Vi" = (
/obj/structure/broken_door,
/turf/simulated/floor/exoplanet/snow,
/area/template_noop)
"WC" = (
/obj/structure/grille/broken,
/obj/structure/ice_rock,
/turf/simulated/floor/exoplanet/snow,
/area/template_noop)
"Xh" = (
/obj/structure/aurora/wall_light{
	dir = 4
	},
/turf/simulated/floor/exoplanet/concrete,
/area/map_template/garage)
"XD" = (
/obj/structure/grille/broken,
/turf/simulated/floor/exoplanet/snow,
/area/template_noop)
"XN" = (
/obj/structure/table/rack/dark,
/turf/simulated/floor/exoplanet/snow,
/area/template_noop)
"Yr" = (
/obj/structure/table/rack/dark,
/obj/item/storage/toolbox/mechanical,
/turf/simulated/floor/exoplanet/concrete,
/area/map_template/garage)
"YK" = (
/obj/structure/railing/mapped,
/turf/simulated/floor/exoplanet/ice,
/area/template_noop)
"Zu" = (
/obj/machinery/door/blast/regular,
/turf/simulated/floor/exoplanet/ice,
/area/map_template/garage)
"ZL" = (
/turf/simulated/floor/exoplanet/snow,
/area/template_noop)

(1,1,1) = {"
wQ
wQ
wQ
wQ
wQ
wQ
wQ
wQ
wQ
wQ
wQ
wQ
wQ
wQ
wQ
wQ
wQ
wQ
wQ
wQ
wQ
wQ
wQ
wQ
wQ
wQ
wQ
wQ
wQ
wQ
wQ
wQ
wQ
wQ
wQ
wQ
wQ
wQ
wQ
wQ
wQ
"}
(2,1,1) = {"
wQ
wQ
wQ
wQ
wQ
wQ
wQ
wQ
wQ
wQ
wQ
wQ
wQ
wQ
wQ
wQ
wQ
wQ
wQ
wQ
wQ
wQ
wQ
wQ
wQ
wQ
wQ
wQ
wQ
wQ
wQ
wQ
wQ
wQ
wQ
wQ
wQ
wQ
wQ
wQ
wQ
"}
(3,1,1) = {"
wQ
wQ
wQ
wQ
wQ
wQ
wQ
wQ
wQ
wQ
wQ
wQ
wQ
wQ
wQ
wQ
wQ
wQ
wQ
wQ
wQ
wQ
wQ
wQ
wQ
wQ
wQ
wQ
wQ
wQ
wQ
wQ
wQ
wQ
wQ
wQ
wQ
wQ
wQ
wQ
wQ
"}
(4,1,1) = {"
wQ
wQ
wQ
wQ
wQ
wQ
wQ
wQ
wQ
wQ
wQ
wQ
wQ
wQ
wQ
wQ
wQ
wQ
wQ
wQ
wQ
wQ
wQ
wQ
wQ
wQ
wQ
wQ
wQ
wQ
wQ
wQ
wQ
wQ
wQ
wQ
wQ
wQ
wQ
wQ
wQ
"}
(5,1,1) = {"
wQ
wQ
wQ
wQ
wQ
wQ
wQ
wQ
wQ
wQ
wQ
wQ
wQ
wQ
wQ
wQ
wQ
wQ
wQ
wQ
wQ
wQ
wQ
wQ
wQ
wQ
wQ
wQ
wQ
wQ
wQ
wQ
wQ
wQ
wQ
wQ
wQ
wQ
wQ
wQ
wQ
"}
(6,1,1) = {"
wQ
wQ
wQ
wQ
wQ
wQ
wQ
wQ
wQ
wQ
wQ
wQ
wQ
wQ
wQ
wQ
wQ
wQ
wQ
wQ
wQ
wQ
wQ
wQ
wQ
wQ
wQ
wQ
wQ
wQ
wQ
wQ
wQ
wQ
wQ
wQ
wQ
wQ
wQ
wQ
wQ
"}
(7,1,1) = {"
wQ
wQ
wQ
wQ
wQ
wQ
wQ
wQ
wQ
wQ
wQ
wQ
wQ
wQ
wQ
wQ
wQ
wQ
wQ
wQ
wQ
wQ
wQ
wQ
wQ
wQ
wQ
wQ
wQ
wQ
wQ
wQ
wQ
wQ
wQ
wQ
wQ
wQ
wQ
wQ
wQ
"}
(8,1,1) = {"
wQ
wQ
wQ
wQ
wQ
wQ
wQ
wQ
wQ
wQ
wQ
wQ
wQ
wQ
wQ
wQ
wQ
wQ
cc
cc
cc
cc
cc
cc
cc
cc
cc
cc
cc
cc
cc
wQ
wQ
wQ
wQ
wQ
wQ
wQ
wQ
wQ
wQ
"}
(9,1,1) = {"
wQ
wQ
wQ
wQ
wQ
wQ
wQ
wQ
wQ
wQ
wQ
wQ
wQ
wQ
wQ
wQ
wQ
wQ
cc
Fi
Fi
GF
Yr
xG
UL
GF
xG
eL
GF
xG
cc
wQ
wQ
wQ
wQ
wQ
wQ
wQ
wQ
wQ
wQ
"}
(10,1,1) = {"
wQ
wQ
wQ
wQ
wQ
wQ
wQ
wQ
wQ
wQ
wQ
wQ
wQ
wQ
wQ
wQ
wQ
wQ
cc
Fi
Fi
xG
xG
IH
xG
xG
wn
xG
xG
xG
cc
hn
wQ
wQ
wQ
wQ
wQ
wQ
wQ
wQ
wQ
"}
(11,1,1) = {"
wQ
wQ
wQ
wQ
wQ
wQ
wQ
wQ
wQ
wQ
wQ
wQ
wQ
wQ
wQ
wQ
wQ
uX
cc
pl
xG
wn
op
xG
wn
op
qL
wn
xG
xG
Zu
wQ
wQ
wQ
wQ
wQ
wQ
wQ
wQ
wQ
wQ
"}
(12,1,1) = {"
wQ
wQ
wQ
wQ
wQ
wQ
wQ
wQ
wQ
wQ
wQ
wQ
wQ
wQ
wQ
wQ
wQ
wQ
cc
pl
op
op
op
cg
cg
cg
cg
xG
xG
xG
Zu
wQ
wQ
wQ
wQ
wQ
wQ
wQ
wQ
wQ
wQ
"}
(13,1,1) = {"
wQ
wQ
wQ
wQ
wQ
wQ
wQ
wQ
wQ
wQ
wQ
wQ
wQ
wQ
wQ
wQ
wQ
wQ
cc
aF
op
lJ
op
Ih
cg
cg
cg
xG
xG
xG
Zu
wQ
wQ
wQ
wQ
wQ
wQ
wQ
wQ
wQ
wQ
"}
(14,1,1) = {"
wQ
wQ
wQ
wQ
wQ
wQ
wQ
wQ
wQ
wQ
wQ
wQ
wQ
wQ
wQ
wQ
wQ
wQ
cc
Hk
ZL
ZL
ZL
ZL
op
op
FP
op
wn
xG
Zu
wQ
wQ
wQ
wQ
wQ
wQ
wQ
wQ
wQ
wQ
"}
(15,1,1) = {"
wQ
wQ
wQ
wQ
wQ
wQ
wQ
wQ
wQ
wQ
wQ
wQ
wQ
wQ
wQ
wQ
wQ
wQ
cc
ZL
ZL
ZL
ZL
ZL
ZL
op
op
op
xG
xG
cc
hn
wQ
oS
wQ
wQ
wQ
wQ
wQ
wQ
wQ
"}
(16,1,1) = {"
wQ
wQ
wQ
wQ
wQ
wQ
wQ
wQ
wQ
wQ
wQ
wQ
wQ
wQ
wQ
wQ
wQ
wQ
oS
oS
oS
ZL
oS
ZL
op
FP
op
op
xG
xG
cc
wQ
oS
oS
oS
oS
wQ
wQ
wQ
wQ
wQ
"}
(17,1,1) = {"
wQ
wQ
wQ
wQ
wQ
wQ
wQ
wQ
wQ
wQ
wQ
wQ
wQ
wQ
wQ
wQ
wQ
oS
oS
oS
oS
oS
oS
fn
op
xG
Xh
wn
Xh
xG
cc
wQ
oS
oS
oS
oS
wQ
wQ
wQ
wQ
wQ
"}
(18,1,1) = {"
wQ
wQ
wQ
wQ
wQ
wQ
wQ
wQ
wQ
wQ
wQ
wQ
wQ
wQ
wQ
wQ
wQ
oS
oS
oS
fr
oS
cc
cc
Nd
Nd
cc
cc
cc
cc
cc
oS
oS
oS
oS
oS
wQ
wQ
wQ
wQ
wQ
"}
(19,1,1) = {"
wQ
wQ
wQ
wQ
wQ
wQ
wQ
wQ
wQ
wQ
wQ
wQ
wQ
Ek
Ek
Ek
Ek
Ek
oS
vR
vR
vR
lN
fr
fr
lS
fr
fr
fr
oS
oS
oS
oS
oS
oS
wQ
wQ
wQ
wQ
wQ
wQ
"}
(20,1,1) = {"
wQ
wQ
wQ
wQ
wQ
wQ
wQ
wQ
wQ
wQ
wQ
wQ
Gy
Ek
vg
KT
XN
Ek
fr
fr
zk
fr
fr
fr
qc
zW
ua
fr
qc
oS
oS
oS
oS
oS
wQ
wQ
wQ
wQ
wQ
wQ
wQ
"}
(21,1,1) = {"
wQ
wQ
wQ
wQ
wQ
wQ
wQ
wQ
wQ
wQ
wQ
wQ
uX
Ek
qM
KT
cb
Ek
fr
fH
gP
ZL
lS
lS
lS
lS
lS
gP
oS
oS
By
wQ
wQ
wQ
wQ
wQ
wQ
wQ
wQ
wQ
wQ
"}
(22,1,1) = {"
wQ
wQ
wQ
wQ
wQ
wQ
wQ
wQ
wQ
wQ
wQ
wQ
fr
Ek
uE
ZL
ZL
Ek
fr
zk
ZL
Pl
ZL
ZL
Pl
lS
xu
lS
fr
fr
By
wQ
wQ
wQ
wQ
wQ
wQ
wQ
wQ
wQ
wQ
"}
(23,1,1) = {"
wQ
wQ
wQ
wQ
wQ
wQ
wQ
wQ
wQ
wQ
wQ
fr
fr
Ek
Pk
IS
lO
Ek
hq
fr
lS
lS
lS
ZL
ZL
Pl
lS
lS
fr
fr
Pi
wQ
wQ
wQ
wQ
wQ
wQ
wQ
wQ
wQ
wQ
"}
(24,1,1) = {"
wQ
wQ
wQ
wQ
wQ
wQ
wQ
wQ
wQ
fr
fr
fr
fr
ZL
br
Lx
OQ
Vi
lS
oS
lS
ZL
Pl
ZL
lS
lS
lS
lS
TO
fr
Pi
wQ
wQ
wQ
wQ
wQ
wQ
wQ
wQ
wQ
wQ
"}
(25,1,1) = {"
wQ
wQ
wQ
wQ
wQ
wQ
wQ
wQ
wQ
wQ
fr
fr
fr
Ek
wa
IS
lO
Ek
oS
oS
ZL
kt
lS
lS
Pl
ZL
lS
Pl
fr
fr
Pi
wQ
wQ
wQ
wQ
wQ
wQ
wQ
wQ
wQ
wQ
"}
(26,1,1) = {"
wQ
wQ
wQ
wQ
wQ
wQ
wQ
wQ
wQ
wQ
fr
fr
fr
Ek
bI
KT
XN
Ek
oS
oS
lS
lS
lS
lS
lS
ZL
ZL
ZL
fr
fr
By
oS
wQ
wQ
wQ
wQ
wQ
wQ
wQ
wQ
wQ
"}
(27,1,1) = {"
wQ
wQ
wQ
wQ
wQ
wQ
wQ
wQ
wQ
wQ
fr
fr
fr
WC
Tb
ZL
KT
Ek
fr
YK
BS
lS
lS
lS
lS
lS
ZL
Lx
zk
fr
Eo
oS
oS
wQ
wQ
wQ
wQ
wQ
wQ
wQ
wQ
"}
(28,1,1) = {"
wQ
wQ
wQ
wQ
wQ
wQ
wQ
wQ
wQ
wQ
fr
fr
fr
XD
tT
ZL
Lx
Ek
fr
fr
AB
fr
bX
fr
fr
zW
fr
zk
fr
fr
eb
oS
oS
wQ
wQ
wQ
wQ
wQ
wQ
wQ
wQ
"}
(29,1,1) = {"
wQ
wQ
wQ
wQ
wQ
wQ
wQ
wQ
wQ
wQ
fr
fr
fr
WC
XD
XD
Ek
Ek
fr
oS
oS
fr
fr
fr
HI
lS
HI
fr
fr
fr
oS
oS
oS
wQ
wQ
wQ
wQ
wQ
wQ
wQ
wQ
"}
(30,1,1) = {"
wQ
wQ
wQ
wQ
wQ
wQ
wQ
wQ
wQ
wQ
wQ
wQ
fr
fr
Hd
vR
qc
vR
vR
oS
xJ
xJ
xJ
xJ
xJ
GD
xJ
xJ
xJ
xJ
xJ
oS
wQ
wQ
wQ
wQ
wQ
wQ
wQ
wQ
wQ
"}
(31,1,1) = {"
wQ
wQ
wQ
wQ
wQ
wQ
wQ
wQ
wQ
wQ
wQ
wQ
wQ
wQ
fr
fr
fr
fr
oS
oS
xJ
rp
rp
ib
ZL
ZL
Lx
ZL
Lx
rp
xJ
wQ
wQ
wQ
wQ
wQ
wQ
wQ
wQ
wQ
wQ
"}
(32,1,1) = {"
wQ
wQ
wQ
wQ
wQ
wQ
wQ
wQ
wQ
wQ
wQ
wQ
wQ
wQ
fr
qc
wQ
wQ
wQ
wQ
xJ
zc
zc
ZL
Lx
ZL
ZL
ZL
zc
zc
xJ
wQ
wQ
wQ
wQ
wQ
wQ
wQ
wQ
wQ
wQ
"}
(33,1,1) = {"
wQ
wQ
wQ
wQ
wQ
wQ
wQ
wQ
wQ
wQ
wQ
wQ
wQ
wQ
wQ
fr
wQ
wQ
wQ
wQ
xJ
CI
kM
oS
mb
uE
mb
ZL
kM
wv
xJ
Td
wQ
wQ
wQ
wQ
wQ
wQ
wQ
wQ
wQ
"}
(34,1,1) = {"
wQ
wQ
wQ
wQ
wQ
wQ
wQ
wQ
wQ
wQ
wQ
wQ
wQ
wQ
wQ
wQ
wQ
wQ
wQ
wQ
xJ
xJ
xJ
oS
oS
XD
XD
XD
xJ
xJ
xJ
wQ
wQ
wQ
wQ
wQ
wQ
wQ
wQ
wQ
wQ
"}
(35,1,1) = {"
wQ
wQ
wQ
wQ
wQ
wQ
wQ
wQ
wQ
wQ
wQ
wQ
wQ
wQ
wQ
wQ
wQ
wQ
wQ
wQ
wQ
wQ
oS
oS
oS
oS
ZL
ZL
wQ
wQ
wQ
wQ
wQ
wQ
wQ
wQ
wQ
wQ
wQ
wQ
wQ
"}
(36,1,1) = {"
wQ
wQ
wQ
wQ
wQ
wQ
wQ
wQ
wQ
wQ
wQ
wQ
wQ
wQ
wQ
wQ
wQ
wQ
wQ
wQ
wQ
oS
oS
oS
oS
oS
oS
Lx
wQ
wQ
wQ
wQ
wQ
wQ
wQ
wQ
wQ
wQ
wQ
wQ
wQ
"}
(37,1,1) = {"
wQ
wQ
wQ
wQ
wQ
wQ
wQ
wQ
wQ
wQ
wQ
wQ
wQ
wQ
wQ
wQ
wQ
wQ
wQ
wQ
wQ
wQ
oS
oS
oS
oS
ZL
ZL
ZL
wQ
wQ
wQ
wQ
wQ
wQ
wQ
wQ
wQ
wQ
wQ
wQ
"}
(38,1,1) = {"
wQ
wQ
wQ
wQ
wQ
wQ
wQ
wQ
wQ
wQ
wQ
wQ
wQ
wQ
wQ
wQ
wQ
wQ
wQ
wQ
wQ
wQ
wQ
oS
oS
wQ
wQ
wQ
wQ
wQ
wQ
wQ
wQ
wQ
wQ
wQ
wQ
wQ
wQ
wQ
wQ
"}
(39,1,1) = {"
wQ
wQ
wQ
wQ
wQ
wQ
wQ
wQ
wQ
wQ
wQ
wQ
wQ
wQ
wQ
wQ
wQ
wQ
wQ
wQ
wQ
wQ
wQ
wQ
oS
wQ
wQ
wQ
wQ
wQ
wQ
wQ
wQ
wQ
wQ
wQ
wQ
wQ
wQ
wQ
wQ
"}
(40,1,1) = {"
wQ
wQ
wQ
wQ
wQ
wQ
wQ
wQ
wQ
wQ
wQ
wQ
wQ
wQ
wQ
wQ
wQ
wQ
wQ
wQ
wQ
wQ
wQ
wQ
wQ
wQ
wQ
wQ
wQ
wQ
wQ
wQ
wQ
wQ
wQ
wQ
wQ
wQ
wQ
wQ
wQ
"}
(41,1,1) = {"
wQ
wQ
wQ
wQ
wQ
wQ
wQ
wQ
wQ
wQ
wQ
wQ
wQ
wQ
wQ
wQ
wQ
wQ
wQ
wQ
wQ
wQ
wQ
wQ
wQ
wQ
wQ
wQ
wQ
wQ
wQ
wQ
wQ
wQ
wQ
wQ
wQ
wQ
wQ
wQ
wQ
"}
(42,1,1) = {"
wQ
wQ
wQ
wQ
wQ
wQ
wQ
wQ
wQ
wQ
wQ
wQ
wQ
wQ
wQ
wQ
wQ
wQ
wQ
wQ
wQ
wQ
wQ
wQ
wQ
wQ
wQ
wQ
wQ
wQ
wQ
wQ
wQ
wQ
wQ
wQ
wQ
wQ
wQ
wQ
wQ
"}
(43,1,1) = {"
wQ
wQ
wQ
wQ
wQ
wQ
wQ
wQ
wQ
wQ
wQ
wQ
wQ
wQ
wQ
wQ
wQ
wQ
wQ
wQ
wQ
wQ
wQ
wQ
wQ
wQ
wQ
wQ
wQ
wQ
wQ
wQ
wQ
wQ
wQ
wQ
wQ
wQ
wQ
wQ
wQ
"}
(44,1,1) = {"
wQ
wQ
wQ
wQ
wQ
wQ
wQ
wQ
wQ
wQ
wQ
wQ
wQ
wQ
wQ
wQ
wQ
wQ
wQ
wQ
wQ
wQ
wQ
wQ
wQ
wQ
wQ
wQ
wQ
wQ
wQ
wQ
wQ
wQ
wQ
wQ
wQ
wQ
wQ
wQ
wQ
"}
