//MAP CONVERTED BY dmm2tgm.py THIS HEADER COMMENT PREVENTS RECONVERSION, DO NOT REMOVE
"fr" = (
/turf/simulated/floor/exoplanet/grass,
/area/template_noop)
"HI" = (
/turf/template_noop,
/area/template_noop)

(1,1,1) = {"
HI
HI
HI
HI
HI
HI
HI
HI
HI
HI
HI
HI
HI
HI
HI
HI
HI
HI
HI
HI
HI
HI
HI
HI
HI
HI
HI
HI
HI
HI
HI
HI
HI
HI
HI
HI
HI
HI
HI
HI
HI
"}
(2,1,1) = {"
HI
HI
HI
HI
HI
HI
HI
HI
HI
HI
HI
HI
HI
HI
HI
HI
HI
HI
HI
HI
HI
HI
HI
HI
HI
HI
HI
HI
HI
HI
HI
HI
HI
HI
HI
HI
HI
HI
HI
HI
HI
"}
(3,1,1) = {"
HI
HI
HI
HI
HI
HI
HI
HI
HI
HI
HI
HI
HI
HI
HI
HI
HI
HI
HI
HI
HI
HI
HI
HI
HI
HI
HI
HI
HI
HI
HI
HI
HI
HI
HI
HI
HI
HI
HI
HI
HI
"}
(4,1,1) = {"
HI
HI
HI
HI
HI
HI
HI
HI
HI
HI
HI
HI
HI
HI
HI
HI
HI
HI
HI
HI
HI
HI
HI
HI
HI
HI
HI
HI
HI
HI
HI
HI
HI
HI
HI
HI
HI
HI
HI
HI
HI
"}
(5,1,1) = {"
HI
HI
HI
HI
HI
HI
HI
HI
HI
HI
HI
HI
HI
HI
HI
HI
HI
HI
HI
HI
HI
HI
HI
HI
HI
HI
HI
HI
HI
HI
HI
HI
HI
HI
HI
HI
HI
HI
HI
HI
HI
"}
(6,1,1) = {"
HI
HI
HI
HI
HI
HI
HI
HI
HI
HI
HI
HI
HI
HI
HI
HI
HI
HI
HI
HI
HI
HI
HI
HI
HI
HI
HI
HI
HI
HI
HI
HI
HI
HI
HI
HI
HI
HI
HI
HI
HI
"}
(7,1,1) = {"
HI
HI
HI
HI
HI
HI
HI
HI
HI
HI
HI
HI
HI
HI
HI
HI
HI
HI
HI
HI
HI
HI
HI
HI
HI
HI
HI
HI
HI
HI
HI
HI
HI
HI
HI
HI
HI
HI
HI
HI
HI
"}
(8,1,1) = {"
HI
HI
HI
HI
HI
HI
HI
HI
HI
HI
HI
HI
HI
HI
HI
HI
HI
HI
HI
HI
HI
HI
HI
HI
HI
HI
HI
HI
HI
HI
HI
HI
HI
HI
HI
HI
HI
HI
HI
HI
HI
"}
(9,1,1) = {"
HI
HI
HI
HI
HI
HI
HI
HI
HI
HI
HI
HI
HI
HI
HI
HI
HI
HI
HI
HI
HI
HI
HI
HI
HI
HI
HI
HI
HI
HI
HI
HI
HI
HI
HI
HI
HI
HI
HI
HI
HI
"}
(10,1,1) = {"
HI
HI
HI
HI
HI
HI
HI
HI
HI
HI
HI
HI
HI
HI
HI
HI
HI
HI
fr
fr
fr
fr
fr
fr
HI
HI
HI
HI
HI
HI
HI
HI
HI
HI
HI
HI
HI
HI
HI
HI
HI
"}
(11,1,1) = {"
HI
HI
HI
HI
HI
HI
HI
HI
HI
HI
HI
HI
HI
HI
HI
fr
fr
fr
fr
fr
fr
fr
fr
fr
HI
HI
HI
HI
HI
HI
HI
HI
HI
HI
HI
HI
HI
HI
HI
HI
HI
"}
(12,1,1) = {"
HI
HI
HI
HI
HI
HI
HI
HI
HI
HI
HI
HI
HI
HI
HI
fr
fr
fr
fr
fr
fr
fr
fr
fr
fr
fr
fr
fr
fr
HI
HI
HI
HI
HI
HI
HI
HI
HI
HI
HI
HI
"}
(13,1,1) = {"
HI
HI
HI
HI
HI
HI
HI
HI
HI
HI
HI
fr
fr
fr
fr
fr
fr
fr
fr
fr
fr
fr
fr
fr
fr
fr
fr
fr
fr
HI
HI
HI
HI
HI
HI
fr
fr
fr
fr
fr
HI
"}
(14,1,1) = {"
HI
HI
HI
HI
HI
HI
HI
HI
HI
HI
HI
fr
fr
fr
fr
fr
fr
fr
fr
fr
fr
fr
fr
fr
fr
fr
fr
fr
fr
fr
fr
fr
HI
HI
HI
fr
fr
fr
fr
fr
HI
"}
(15,1,1) = {"
HI
HI
HI
HI
HI
HI
HI
HI
HI
HI
HI
fr
fr
fr
fr
fr
fr
fr
fr
fr
fr
fr
fr
fr
fr
fr
fr
fr
fr
fr
fr
fr
HI
fr
fr
fr
fr
fr
fr
fr
HI
"}
(16,1,1) = {"
HI
HI
HI
HI
HI
HI
HI
HI
HI
HI
HI
fr
fr
fr
fr
fr
fr
fr
fr
fr
fr
fr
fr
fr
fr
fr
fr
fr
fr
fr
fr
fr
fr
fr
fr
fr
fr
fr
fr
fr
HI
"}
(17,1,1) = {"
HI
HI
HI
HI
HI
HI
HI
HI
HI
HI
HI
HI
HI
fr
fr
fr
fr
fr
fr
fr
fr
fr
fr
fr
fr
fr
fr
fr
fr
fr
fr
fr
fr
fr
fr
fr
fr
fr
HI
HI
HI
"}
(18,1,1) = {"
HI
HI
HI
HI
HI
HI
HI
HI
HI
HI
HI
HI
HI
fr
fr
fr
fr
fr
fr
fr
fr
fr
fr
fr
fr
fr
fr
fr
fr
fr
fr
fr
fr
fr
fr
fr
fr
fr
HI
HI
HI
"}
(19,1,1) = {"
HI
HI
HI
HI
HI
HI
HI
HI
HI
HI
HI
HI
HI
fr
fr
fr
fr
fr
fr
fr
fr
fr
fr
fr
fr
fr
fr
fr
fr
fr
fr
fr
fr
fr
fr
fr
fr
fr
HI
HI
HI
"}
(20,1,1) = {"
HI
HI
HI
HI
HI
HI
HI
HI
HI
HI
HI
HI
HI
fr
fr
fr
fr
fr
fr
fr
fr
fr
fr
fr
fr
fr
fr
fr
fr
fr
fr
fr
fr
fr
fr
fr
fr
fr
HI
HI
HI
"}
(21,1,1) = {"
HI
HI
HI
HI
HI
HI
HI
HI
HI
HI
HI
HI
HI
fr
fr
fr
fr
fr
fr
fr
fr
fr
fr
fr
fr
fr
fr
fr
fr
fr
fr
fr
fr
fr
fr
HI
HI
HI
HI
HI
HI
"}
(22,1,1) = {"
HI
HI
HI
HI
HI
HI
HI
HI
HI
HI
HI
HI
HI
HI
HI
fr
fr
fr
fr
fr
fr
fr
fr
fr
fr
fr
fr
fr
fr
fr
fr
fr
fr
fr
fr
HI
HI
HI
HI
HI
HI
"}
(23,1,1) = {"
HI
HI
HI
HI
HI
HI
HI
HI
HI
HI
HI
HI
HI
HI
HI
fr
fr
fr
fr
fr
fr
fr
fr
fr
fr
fr
fr
HI
fr
fr
fr
fr
fr
fr
fr
HI
HI
HI
HI
HI
HI
"}
(24,1,1) = {"
HI
HI
HI
HI
HI
HI
HI
HI
HI
HI
HI
HI
HI
HI
HI
HI
HI
fr
fr
fr
fr
fr
fr
fr
fr
fr
fr
HI
fr
fr
fr
fr
fr
fr
fr
HI
HI
HI
HI
HI
HI
"}
(25,1,1) = {"
HI
HI
HI
HI
HI
HI
HI
HI
HI
HI
HI
HI
HI
HI
HI
HI
HI
fr
fr
fr
fr
fr
fr
fr
fr
fr
fr
HI
fr
fr
fr
fr
fr
fr
fr
HI
HI
HI
HI
HI
HI
"}
(26,1,1) = {"
HI
HI
HI
HI
HI
HI
HI
HI
HI
HI
HI
HI
HI
HI
HI
HI
HI
HI
fr
fr
fr
fr
fr
fr
fr
fr
HI
HI
HI
HI
HI
HI
HI
HI
HI
HI
HI
HI
HI
HI
HI
"}
(27,1,1) = {"
HI
HI
HI
HI
HI
HI
HI
HI
HI
HI
HI
HI
HI
HI
HI
HI
HI
HI
fr
fr
fr
fr
fr
fr
fr
fr
HI
HI
HI
HI
HI
HI
HI
HI
HI
HI
HI
HI
HI
HI
HI
"}
(28,1,1) = {"
HI
HI
HI
HI
HI
HI
HI
HI
HI
HI
HI
HI
HI
HI
HI
HI
HI
HI
fr
fr
fr
fr
fr
fr
fr
fr
HI
HI
HI
HI
HI
HI
HI
HI
HI
HI
HI
HI
HI
HI
HI
"}
(29,1,1) = {"
HI
HI
HI
HI
HI
HI
HI
HI
HI
HI
HI
HI
HI
HI
HI
HI
HI
HI
HI
HI
HI
HI
HI
HI
HI
HI
HI
HI
HI
HI
HI
HI
HI
HI
HI
HI
HI
HI
HI
HI
HI
"}
(30,1,1) = {"
HI
HI
HI
HI
HI
HI
HI
HI
HI
HI
HI
HI
HI
HI
HI
HI
HI
HI
HI
HI
HI
HI
HI
HI
HI
HI
HI
HI
HI
HI
HI
HI
HI
HI
HI
HI
HI
HI
HI
HI
HI
"}
(31,1,1) = {"
HI
HI
HI
HI
HI
HI
HI
HI
HI
HI
HI
HI
HI
HI
HI
HI
HI
HI
HI
HI
HI
HI
HI
HI
HI
HI
HI
HI
HI
HI
HI
HI
HI
HI
HI
HI
HI
HI
HI
HI
HI
"}
(32,1,1) = {"
HI
HI
HI
HI
HI
HI
HI
HI
HI
HI
HI
HI
HI
HI
HI
HI
HI
HI
HI
HI
HI
HI
HI
HI
HI
HI
HI
HI
HI
HI
HI
HI
HI
HI
HI
HI
HI
HI
HI
HI
HI
"}
(33,1,1) = {"
HI
HI
HI
HI
HI
HI
HI
HI
HI
HI
HI
HI
HI
HI
HI
HI
HI
HI
HI
HI
HI
HI
HI
HI
HI
HI
HI
HI
HI
HI
HI
HI
HI
HI
HI
HI
HI
HI
HI
HI
HI
"}
(34,1,1) = {"
HI
HI
HI
HI
HI
HI
HI
HI
HI
HI
HI
HI
HI
HI
HI
HI
HI
HI
HI
HI
HI
HI
HI
HI
HI
HI
HI
HI
HI
HI
HI
HI
HI
HI
HI
HI
HI
HI
HI
HI
HI
"}
(35,1,1) = {"
HI
HI
HI
HI
HI
HI
HI
HI
HI
HI
HI
HI
HI
HI
HI
HI
HI
HI
HI
HI
HI
HI
HI
HI
HI
HI
HI
HI
HI
HI
HI
HI
HI
HI
HI
HI
HI
HI
HI
HI
HI
"}
(36,1,1) = {"
HI
HI
HI
HI
HI
HI
HI
HI
HI
HI
HI
HI
HI
HI
HI
HI
HI
HI
HI
HI
HI
HI
HI
HI
HI
HI
HI
HI
HI
HI
HI
HI
HI
HI
HI
HI
HI
HI
HI
HI
HI
"}
(37,1,1) = {"
HI
HI
HI
HI
HI
HI
HI
HI
HI
HI
HI
HI
HI
HI
HI
HI
HI
HI
HI
HI
HI
HI
HI
HI
HI
HI
HI
HI
HI
HI
HI
HI
HI
HI
HI
HI
HI
HI
HI
HI
HI
"}
(38,1,1) = {"
HI
HI
HI
HI
HI
HI
HI
HI
HI
HI
HI
HI
HI
HI
HI
HI
HI
HI
HI
HI
HI
HI
HI
HI
HI
HI
HI
HI
HI
HI
HI
HI
HI
HI
HI
HI
HI
HI
HI
HI
HI
"}
(39,1,1) = {"
HI
HI
HI
HI
HI
HI
HI
HI
HI
HI
HI
HI
HI
HI
HI
HI
HI
HI
HI
HI
HI
HI
HI
HI
HI
HI
HI
HI
HI
HI
HI
HI
HI
HI
HI
HI
HI
HI
HI
HI
HI
"}
(40,1,1) = {"
HI
HI
HI
HI
HI
HI
HI
HI
HI
HI
HI
HI
HI
HI
HI
HI
HI
HI
HI
HI
HI
HI
HI
HI
HI
HI
HI
HI
HI
HI
HI
HI
HI
HI
HI
HI
HI
HI
HI
HI
HI
"}
(41,1,1) = {"
HI
HI
HI
HI
HI
HI
HI
HI
HI
HI
HI
HI
HI
HI
HI
HI
HI
HI
HI
HI
HI
HI
HI
HI
HI
HI
HI
HI
HI
HI
HI
HI
HI
HI
HI
HI
HI
HI
HI
HI
HI
"}
(42,1,1) = {"
HI
HI
HI
HI
HI
HI
HI
HI
HI
HI
HI
HI
HI
HI
HI
HI
HI
HI
HI
HI
HI
HI
HI
HI
HI
HI
HI
HI
HI
HI
HI
HI
HI
HI
HI
HI
HI
HI
HI
HI
HI
"}
(43,1,1) = {"
HI
HI
HI
HI
HI
HI
HI
HI
HI
HI
HI
HI
HI
HI
HI
HI
HI
HI
HI
HI
HI
HI
HI
HI
HI
HI
HI
HI
HI
HI
HI
HI
HI
HI
HI
HI
HI
HI
HI
HI
HI
"}
(44,1,1) = {"
HI
HI
HI
HI
HI
HI
HI
HI
HI
HI
HI
HI
HI
HI
HI
HI
HI
HI
HI
HI
HI
HI
HI
HI
HI
HI
HI
HI
HI
HI
HI
HI
HI
HI
HI
HI
HI
HI
HI
HI
HI
"}
